Mm^Xm, Mm^Xm, Mm^Xm, Mm, Mm, Mm, Mm, Mm, Mm, Gs, Hh, Gs, Re, Gs, Hh, Gs, Mm, Gs, Mm, Mm, Mm, Mm, Mm^Xm, Mm^Xm, Mm^Xm, Mm^Xm, Mm^Xm, Mm^Xm, Mm^Xm, Mm^Xm, Mm^Xm, Mm^Xm, Mm^Xm, Mm^Xm, Mm^Xm, Mm, Mm, Mm, Mm, Mm, Hh, Hh, Hh, Gs, Hh, Hh, Hh^Fp, Hh, Hh^Fp, Gs^Fp, Hh^Fp, Gs
Mm, Mm^Xm, Mm^Xm, Mm^Xm, Mm, Mm, Mm, Mm, Hh^Fp, Hh, Hh, Re, 5 Gs, Gs, Hh, Mm, Hh^Fp, Mm, Mm, Mm, Mm^Xm, Mm^Xm, Mm^Xm, Mm^Xm, Mm^Xm, Mm^Xm, Mm^Xm, Mm^Xm, Mm, Mm^Xm, Mm^Xm, Mm^Xm, Mm, Mm^Xm, Mm, Mm, Mm, Mm, Mm, Mm, Hh, Hh, Mm, Mm, Hh^Fp, Hh, Hh, Hh^Fp, Hh^Fmw, Hh^Fp, Hh^Fmw, Hh^Fp
Mm, Mm^Xm, Mm^Xm, Mm^Xm, Mm^Xm, Mm, Mm, Hh^Fmw, Hh^Fp, Hh, Hh, Re, Re, Gs, Hh, Hh^Fp, Hh, Mm, Hh, Mm, Mm^Xm, Mm^Xm, Mm^Xm, Mm^Xm, Mm, Mm^Xm, Mm, Mm, Mm^Xm, Mm^Xm, Mm, Mm, Mm, Mm, Mm, Mm, Mm, Mm, Hh^Fp, Hh^Fp, Gs^Fmw, Hh^Fp, Mm^Xm, Mm, Hh^Fp, Hh, Hh^Fp, Hh, Gs^Fp, Gs^Fp, Hh^Fp, Hh
Mm, Mm, Mm^Xm, Mm^Xm, Mm^Xm, Mm, Mm, Hh^Fp, Hh^Fp, Gs^Fp, Gs^Fp, Gs, Re, Gs^Efm, Gs^Fp, Hh^Fmw, Hh, Mm, Hh^Fmw, Mm, Mm, Mm^Xm, Mm, Mm, Mm, Mm, Mm, Mm^Xm, Mm^Xm, Mm, Mm, Mm, Mm, Mm, Hh^Fp, Hh, Hh, Hh, Mm, Gs^Fp, Gs^Fp, Hh^Fp, Mm^Xm, Mm, Hh^Vhh, Hh, Hh^Fp, Hh^Fp, Gs^Fp, Gs^Fmw, Gs^Fp, Hh
Mm, Mm, Mm, Mm^Xm, Mm^Xm, Mm^Xm, Mm, Mm, Mm, Hh^Fp, Hh^Fp, Gs, Gs^Vc, Re, Gs^Efm, Hh, Hh, Hh^Fmw, Mm, Mm, Hh, Mm, Mm, Mm, Mm, Mm, Mm, Mm^Xm, Mm, Mm, Mm, Mm, Hh, Hh^Fp, Gs^Fp, Hh^Fmw, Hh, Mm, Mm^Xm, Hh, Gs^Es, Mm, Mm, Hh, Hh, Hh, Hh^Fp, Hh^Fp, Mm, Hh, Gs^Fp, Hh
Mm, Mm, Mm, Mm, Mm, Mm^Xm, Mm^Xm, Mm, Mm, Hh^Fp, Hh^Fp, Hh^Fp, Gs, Re, Gs, Hh^Fp, Gs^Fp, Hh^Fmw, Hh, Hh, Mm^Fmw, Mm, Mm, Mm, Mm, Mm, Mm, Mm^Xm, Mm^Xm, Mm, Mm, Mm, Mm, Hh^Vhh, Gs^Es, Gd, Gd, Mm, Mm, Hh, Gd, Mm, Gs^Es, Hh, Hh, Hh, Mm^Xm, Mm, Mm, Gs^Fp, Hh, Hh
Mm, Mm, Mm, Mm, Mm, Mm, Mm, Mm^Xm, Mm, Mm, Mm, Hh^Fp, Hh^Fp, Re, Gs^Efm, Gs, Gs^Fp, Hh^Fmw, Hh, Hh^Fmw, Hh^Fmw, Mm, Mm, Mm, Mm, Mm, Mm, Mm, Mm, Mm^Xm, Mm, Mm, Mm, Hh, Hh^Fp, Hh, Gs, Gs^Fp, Hh, Hh^Vhh, Re, Re, Re, Hh, Gs^Es, Mm, Mm, Mm, Hh^Fp, Hh, Hh, Hh
Hh^Fp, Hh^Fp, Hh, Mm, Hh^Fp, Mm, Mm, Mm^Xm, Mm, Mm, Hh^Fmw, Hh^Fp, Hh, Re, Re, Gs, Gs, Hh^Fp, Gs^Fp, Hh^Fmw, Hh, Mm, Mm, Mm, Mm, Mm, Mm, Mm, Mm, Mm, Mm, Mm, Mm, Mm, Mm, Hh^Fp, Hh, Gs, Gs^Es, Gs, Mm, Hh, Hh, Re, Hh, Mm, Mm, Mm, Hh^Fmw, Hh, Mm, Mm
Gs^Fp, Gs^Fmw, Hh, Hh, Hh^Fp, Hh^Fp, Mm, Mm, Mm, Mm, Hh^Fmw, Hh^Fp, Gs^Efm, Gs^Efm, Re, Re, Re, Gs^Efm, Gs^Fp, Hh^Fp, Hh^Fp, Mm, Mm, Mm, Mm, Kh, Ch, Mm, 4 Kud, Ch, Ch, Mm, Mm, Mm, Mm, Hh^Fmw, Hh, Gs^Fp, Mm, Mm^Xm, Mm, Mm, Hh, Re, Gs^Es, Mm, Gs^Fp, Gs^Fp, Hh, Hh, Mm, Mm
Gs, Gs, Gs, Gs, Gs, Hh, Hh, Mm, Mm, Hh, Hh^Fp, Hh^Fp, Gs^Efm, Gs^Efm, Re, Gs^Vc, Hh, Re, Gs^Efm, Hh^Fp, Hh^Fp, Mm, Hh, Mm, Hh, Ch, Ch, Ch, Ch, Ch, Kh, Mm, Hh, Mm, Hh, Hh, Ww, Mm, Mm, Mm, Hh^Fmw, Mm, Hh, Re^Es, Re, Re, Re, Hh^Vhh, Hh^Fp, Mm, Mm^Xm, Mm
Hh, Hh^Fmw, Hh, Hh, Gs, Hh, Gs^Vc, Hh, Mm, Ch^Dr, Hh, Gs, Re, Re, Hh, Hh, Hh, Re, Re, Gs, Gs, Hh, Gs, Hh, Hh, Gs, Gs, Ch, Re, Ch, Gd, Gd, Gs, Hh, Hh, Ww, Gs, Gd, Re, Re^Es, Re, Hh^Fp, Gs^Es, Re, Gd, Hh, Gs^Es, Hh, Mm, Mm, Mm^Xm, Mm
Mm, Mm, Mm, Hh^Fp, Hh^Fp, Gs, Gs, Hh, Hh^Fp, Mm, Hh, Gs, Re, Gs, Hh, Mm, Mm, Hh, Hh, Re, Re, Re, Re, Gs, Re, Gll^Gvs, Gll^Gvs, Gs, Rp, Gll^Gvs, Gll^Gvs, Gs^Vh, Re, Gs, Re, Gs, Re, Re^Es, Mm, Mm, Hh^Vhh, Re, Re, Re, Hh, Hh^Fp, Mm, Mm, Mm^Xm, Mm, Mm^Xm, Mm
Mm, Mm, Mm, Hh^Fp, Hh, Gs, Gs, Hh, Hh^Fp, Hh^Fp, Hh, Ce, Ce, Hh, Hh^Fp, Mm, Mm, Hh^Fp, Hh^Fp, Hh, Hh, Hh, Gs, Re, Gll^Gvs, Re, Rp, Gs^Vh, Rp, Re, Re, Re, Gs, Re, Gs, Re, Gs^Es, Mm, Mm, Mm, Hh^Fp, Hh, Re^Es, Gs, Hh^Fp, Hh^Fmw, Mm, Mm, Mm^Xm, Mm^Xm, Mm, Mm
Hh^Fms, Mm, Mm, Ch^Dr, Mm, Hh^Fms, Ce, Ce, Gs, Hh, Gd, Re, Gs, Hh, Hh^Fp, Hh^Fp, Mm, Mm^Xm, Mm^Xm, Hh, Mm, Hh, Hh, Gs^Vc, Gll^Gvs, Gll^Gvs, Re, Rp, Gll^Gvs, Gs, Gs^Vh, Gs, Hh, Hh, Hh^Fp, Gs, Gd, Mm, 6 Ke, Mm, Ce, Re, Hh, Hh, Mm, Mm, Mm, Mm, Mm, Mm, Mm, Mm
Hh, Hh^Fms, Mm, Mm, Wwrg, Hh, Hh^Fms, Gs, Gd, Gd^Edt, Gs^Vc, Re, Re^Edt, Gs, Hh, Hh^Fms, Mm, Mm^Xm, Mm, Ch^Dr, Mm, Hh^Fp, Hh^Fp, Gll^Gvs, Gll^Gvs, Gll^Gvs, Re, Gll^Gvs, Gll^Gvs, Gll^Gvs, Gs, Hh, Mm, Hh^Fp, Hh^Fmw, Gs^Fp, Hh, Hh, Ce, Ce, Re, Re, Ch^Dr, Mm, Mm, Mm, Mm, Mm, Mm, Mm, Hh, Hh
Hh, Hh^Fms, Mm, Mm, Ww, Hh, Hh, Gd, Gd, Hh^Dr, Gd^Edt, Re^Edt, Re^Edt, 7 Ke, Hh, Hh, Hh, Mm, Mm, Mm, Hh, Mm, Hh, Hh, Gs, Gs, Gs, Re, Gs, Gs, Hh, Hh, Hh^Fp, Hh^Fmw, Mm, Hh^Fp, Mm, Hh, Hh, Ce, Gs^Edt, Mm^Dr, Mm, Mm, Gs^Fp, Mm, Mm, Mm, Mm, Mm, Hh, Hh
Gs, Hh, Hh, Hh^Fms, Hh, Ww, Ww, Gs, Ce, Hh^Dr, Hh^Dr, Ce, Ce, Ce, Ce, Gd, Gs^Vc, Hh, Hh^Fms, Mm, Hh, Hh, Hh, Ce, Hh, Gs^Edt, Ce, Re^Edt, Ce, Gs^Edt, Ce, Gs^Fp, Hh^Fp, Hh^Fmw, Mm, Mm^Xm, Ch^Dr, Mm, Hh, Hh^Dr, Ce, Ce, Gs^Edt, Hh, Gs^Fp, Hh, Hh^Fp, Hh, Hh, Hh, Hh^Fp, Hh
Gs^Edt, Hh, Gd, Hh, Hh, Gs, Gs, Ww, Re, Re, Re, Gs^Vc, Ce, Re, Re, Re^Edt, Gd, Hh^Fms, Hh^Fms, Wwrg, Hh^Fms, Gs^Fms, Gs^Fms, Hh, Gs, Hh^Dr, Gd^Edt, Ce, Re, Ce, Gd^Edt, Hh^Dr, Hh, Mm, Hh, Mm, Mm, Mm, Hh^Fp, Gs^Edt, Gs, Gs, Gs, Gs, Hh, Gs^Fp, Gs, Hh^Fp, Hh, Hh^Fp, Hh^Fp, Hh
Gs^Edt, Rb, Cer, Gd, Rb, Gd, Gs, Ww^Bw/, Ww, Gs, Re, Re, Hh^Dr, Gd^Edt, Gs^Vc, Gd^Edt, Gs^Fms, Gs^Fms, Gs^Fms, Wwf, Gs^Fms, Gs^Fms, Gll^Gvs, Gll^Gvs, Gll^Gvs, Gd, Gs, Gd, Re, Gd, Re, Hh, Re, Ce, Gs, Hh^Fp, Hh, Mm, Hh^Fp, Hh, Gd, Gs, Hh, Mm, Hh, Gs, Gd, Hh, Gs, Gs^Fp, Hh^Fp, Hh
Gd, Rb^Edt, Rb^Edt, Rb, Cer, Rb, Gd, Gs, Ww, Ce, Re, Gs, Ce, Gs, Gs, Gs, Gs, Ce, Wwf, Wwf, Gs^Fms, Gs^Fms, Gs, Gll^Gvs, Gs, Gll^Gvs, Re, Re, Gll^Gvs, Re, Gs, Re, Gs, Re, Re, Hh, Gs^Fp, Hh, Hh, Gs^Fp, Gs, Gd, Gd, Hh, Gs, Gd, Gd, Gs, Cer, Gs, Hh, Hh
Hh, Gd, Gd^Ecf, Rb, Rb^Edt, Gd, Rb, Gs, Gs, Ww, Ww^Bw|, Ww, Ww, Ww, Ww, Ce, Gs, Wwf, Gs, Gs, Gs, Gs^Fms, Gll^Gvs, Gd^Vhr, Gs, Gs, Re, Gll^Gvs, Gll^Gvs, Gs, Hh, Gs, Hh, Gs, Gs, Re, Gs, Gd, Gd, Gs, Hh, Gd, Gs, Gs, Gd, Gs, Rb, Gs, Rb, Gs, Gs^Fp, Gs^Fp
Hh, Hh, Hh, Gd^Edt, Rb^Edt, Cer, Rb, Gd, Gs, Gs, Gs, Gs, Gs, Gs, Gs, Ww, Ww, Wwf, Gs, Gs, Gll^Gvs, Gll^Gvs, Gll^Gvs, Gll^Gvs, Gll^Gvs, Gll^Gvs, Re, Gs, Gs, Hh, Hh, Hh^Fp, Gs^Fp, Hh, Hh, Re, Re, Gd, Gs, Gs, Rb, Gd, Rb, Rb^Vhr, Rb, Rb, Cer, Rb^Edt, Gd^Ecf, Gd, Hh, Hh^Fp
Hh^Fp, Hh, Hh, Gd, Gd^Ecf, Rb, Cer, Gd, Rb, Gd, Rb, Gd, Rb, Gs, Gd, Gs, Wwr, Gs, Gs, Gll^Gvs, Gs, Gll^Gvs, Gll^Gvs, Gll^Gvs, Gs, Gs, Gs, Re, Gs, Hh, Gs, Gs, Gs, Gs, Gd, Gs, Gd, Rb, Rb, Gd, Cer, Rb, Rb, Cer, Rb^Edt, Rb^Edt, Rb^Edt, Rb^Edt, Gd, Gd, Hh, Hh
Hh, Gs^Fp, Gs^Fp, Gd, Gd, Rb^Edt, Rb^Edt, Rb, Cer, Rb, Cer, Gd, Cer, Rb, Gd, Gd, Gd, Ww, Ww, Gs, Gs, Gs, Gs, Gll^Gvs, Gs, Hh, Gs, Re, Re, Gs, Gd, Gd^Vhr, Rb, Rb, Rb, Rb, Rb, Cer, Rb^Edt, Rb, Rb, Rb, Gd^Ecf, Rb, Rb^Edt, Gd^Ecf, Gd, Gd^Edt, Gd, Hh, Hh^Fmw, Hh
Mm, Hh, Hh, Gs, Gd, Rb, Gd^Ecf, Rb, Rb^Edt, Rb^Edt, Rb^Edt, Rb^Edt, Rb^Edt, Rb, Cer, Rb, Cer, Gd, Ww, Gs, Ww, Gs, Ww, Gs, Gs, Gs, Gd, Gd, Gd, Rb, Rb, Gd, Rb, Cer, Rb^Edt, Cer, Rb^Edt, Rb, Gd^Edt, Gd^Ecf, Gd, Rb, Gd, Gd, Rb, Gd, Rb, Re^Vct, Rb, Gd^Es, Hh, Hh^Fmw
Mm, Hh^Fp, Hh, Hh, Gs, Gd, Rb, Rb, Rb^Es, Rb^Edt, Rb, Rb^Edt, Gd^Ecf, Rb, Rb, Rb, Rb^Edt, Rb, Cer, Ww, Ww, Ww, Wwr, Wwr, Gs, Gs, Gd, Rb, Rb, Cer, Rb^Edt, Cer, Rb, Rb^Edt, Rb^Edt, Rb^Edt, Gd^Ecf, Rb^Edt, Gd, Hhd, Hhd^Fdw, Gd, Hhd, Gd^Es, Rb, Rb, Cd, Rb, Cd, Rb, Hh, Hh^Fmw
Mm, Mm, Hh^Fp, Hh, Hh, Gd^Vct, Rb, Cd, Cd, Cd, Cd, Rb, Gd^Edt, Gd, Gd^Ecf, Gd^Edt, Rb^Edt, Rb^Edt, Rb^Edt, Rb, Cer, Gd, Gd, Ww, Ww, Rb, Rb, Cer, Rb^Edt, Rb^Edt, Rb^Vct, Rb^Edt, Rb, Gd^Ecf, Gd, Gd, Gd, Gd, Hhd, Hhd^Fmw, Gd^Feth, Hhd, Gd, Re^Vct, Rb, Cd, 2 Kd, Cd, Rb^Es, Rb, Hh^Vct, Hh^Fmw
Hh, Mm, Mm, Hh, Gs^Fp, Gd, Gd^Vct, Rb^Es, Cd^Esd, 3 Kd, Cd^Esd, Rb^Edt, Rb^Edt, Hhd, Gd^Edt, Gd, Hhd, Gd^Ecf, Gd, Rb^Edt, Rb^Edt, Rb, Cer, Ww, Ww, Cer, Rb^Edt, Rb^Edt, Rb^Es, Rb^Vct, Cd, Cd, Cd, Rb, Rb^Es, Re^Vct, Rb, Gd, Gd^Es, Gd, Rb, Gd, Rb, Rb, Cd, Cd, Cd, Cd^Esd, Rb^Es, Hh^Vct, Hh, Hh
Hh, Mm, Mm, Hh^Fp, Hh, Gs, Gd^Edt, Rb^Es, Rb^Es, Cd^Esd, Rb, Cd, Rb, Gd^Vct, Gs, Gd, Gd, Hhd, Gd, Rb^Edt, Gd^Ecf, Rb^Edt, Rb^Edt, Rb, Ww, Ww, Gd, Rb^Ecf, Rb^Edt, Cd, Cd^Esd, 1 Kd, Cd^Esd, Cd^Esd, Rb^Es, Rb^Edt, Gd, Rb, Rb, Rb, Gd, Rb, Gd, Rb, Rb, Rb, Rb, Rb^Es, Hh, Hh^Vct, Hh^Fmw, Hh^Fmw
Gll^Fp, Hh^Fp, Hh^Fp, Hh, Hh, Hh, Gs, Gd^Vct, Rb^Edt, Rb, Gd^Vct, Rb^Es, Gd^Edt, Gd, Hh, Hh, Gd^Es, Gd, Gd, Gd, Gd, Gd, Gd^Vct, Gd, Gd, Ww^Bw/, Ww, Gd, Gd^Edt, Rb, Rb, Cd, Rb^Es, Rb, Re^Vct, Gd, Gs, Gs, Gs^Es, Gs^Es, Gs, Rb, Gs, Gd, Gs, Re^Vct, Gs, Re^Vct, Hh, Hh, Hh^Fmw, Hh^Fmw
Gll^Fp, Gll^Fp, Gll^Fp, Hh, Gll^Fp, Hh, Gs, Gs^Edt, Rb^Edt, Gd, Hh, Gd^Edt, Hh, Hh, Hh, Hh, Hh, Hh, Gs, Gd, Gs, Gd, Gs, Gs, Gll^Fp, Ww, Ww, Gs, Hh, Re^Vct, Gd, Rb, Re^Vct, Gd, Gs, Hh, Hh, Hh, Hh, Hh, Hh^Fmw, Rb, Rb, Rb, Rb, Gs^Es, Hh, Hh, Hh, Hh^Fmw, Hh^Fmw, Hh^Fmw
Gll^Fp, Gll^Fp, Gll^Fp, Gll^Fp, Gs, Gs, Rb, Rb, Gs^Es, Gs, Hh, Hh, Hh, Hh^Fp, Mm, Hh^Fp, Hh^Fp, Gs^Fp, Hh, Hh, Hh, Hh, Gll^Fp, Gll^Fp, Gs^Fds, Ww, Ww, Ww, Gs^Fds, Hh, Gll^Fmw, Gs, Hh, Gs, Hh^Fdw, Hh, Hh^Fmw, Mm, Mm, Hh^Fmw, Hh^Fmw, Gs^Fmw, Hh, Gs, Gs, Rb, Gs, Hh, Gs^Es, Hh, Gs^Fmw, Gs^Fmw
Gll^Fp, Gll^Fp, Gs, Gll^Fp, Gs, Gs^Es, Rb, Gs, Hh, Gs^Fp, Hh, Hh, Mm, Mm, Mm, Hh^Fp, Mm, Hh^Fp, Mm, Hh^Fp, Mm, Hh, Hh, Gll^Fp, Gs^Fds, Gs^Fds, Ww, Ww, Ww, Gs^Fds, Gll^Fmw, Gll^Fmw, Hh^Fmw, Hh, Mm, Hh^Fmw, Hh^Fmw, Mm, Mm, Mm, Mm, Hh^Fmw, Hh, Gs^Fmw, Hh^Fmw, Rb, Rb, Gs, Gs, Gs, Gs, Gs
Gs, Gll^Fp, Gs, Gs, Gs, Rb, Gs, Gs, Gs, Hh, Hh, Hh, Mm, Mm, Mm, Mm, Mm, Mm, Mm, Mm, Mm, Mm, Hh, Gll^Fp, Gs, Gs^Fds, Ww, Ww, Ww, Gll^Fp, Gs, Hh, Gs, Mm, Hh, Hh, Hh, Mm, Gs, Mm, Gs, Hh, Gs, Hh, Gs, Gs, Gs, Rb, Gs, Gs, Gs, Gs
