Rp, Gd, Rp, Gd, Gd, Gd, Gd, Gd, Hh^Fp, Hh, Mm, Gg, Mm, Mm, Mm, Mm, Mm, Mm, Mm, Mm, Mm, Mm^Xm, Mm^Xm, Mm^Xm, Mm^Xm, Mm^Xm, Mm^Xm, Mm^Xm, Mm^Xm, Mm^Xm, Mm^Xm, Mm, Mm^Xm, Mm^Xm, Mm^Xm, Mm^Xm, Mm^Xm, Mm^Xm, Mm^Xm, Mm^Xm, Mm^Xm, Mm^Xm, Mm^Xm, Mm^Xm, Mm^Xm, Gg, Mm, Gg, Hh, Hh, Gd, Gd, Hh
Gd, Rp, Rp^Es, Gd, Gd^Gvs, Gd^Gvs, Hh, Hh^Fp, Hh^Fp, Mm, Mm, Mm, Mm, Mm, Mm, Mm, Hh, Mm, Mm, Mm, Mm, Mm, Mm, Mm, Mm, Mm^Xm, Mm, Mm^Xm, Mm^Xm, Mm^Xm, Mm, Mm^Xm, Mm, Mm, Mm, Mm, Mm, Mm, Mm, Mm, Mm, Mm, Mm, Mm, Mm, Mm, Hh^Fp, Hh, Hh^Es, Rp^Es, Gd, Gd, Hh
Gd, Gd, Ias, Gd, Gd^Gvs, Gs^Vc, Hh, Hh^Fp, Hh^Fp, Mm, Mm, Mm, Mm, Hh, Hh, Mm, Hh^Fp, Hh^Fp, Hh^Fp, Hh^Fp, Hh^Fp, Mm, Mm, Mm, Mm, Mm, Mm, Mm^Xm, Mm^Xm, Mm, Mm, Mm, Mm, Mm, Mm, Mm, Hh, Hh^Fp, Hh, Mm, Hh, Mm, Mm, Mm, Hh, Hh^Fp, Hh^Es, Hh^Es, Hh, Ias, Hh^Es, Gd, Hh
Gd, Gd, Gd^Gvs, Ias, 5 Rp, Gd^Gvs, Gd^Es, Gd^Fp, Hh, Hh, Hh, Mm, Hh, Hh, Gd^Fp, Hh^Fp, Hh^Fp, Hh^Fp, Hh^Fp, Hh^Fp, Ch, Mm, Hh^Fp, Mm, Hh^Fp, Cf, Cf, Cf, Cf, Cf, Mm, Mm, Hh^Fp, Hh^Fp, Ch, Hh, Hh, Hh, Hh, Hh^Fp, Hh, Hh, Hh, Hh, Gd^Es, Hh^Es, Hh, Gd, Gd, Gd^Es, Hh^Es, Hh, Hh^Fp
Hh, Gd^Gvs, Gd^Gvs, Gd^Gvs, Ias, Gd^Gvs, Rp, Hh, Hh^Es, Hh^Es, Gd^Es, Hh, Hh, Gd^Fp, Gd^Fp, Hh^Fp, Re^Fp, Cf, Cf, Ch, Ias, Hh^Fp, Hh^Vhc, Ias, Hh, Cf, Kh, 4 Kh, Kh, Cf, Hh, Ias, Hh^Vhc, Hh^Fp, Ias, Ch, Cf, Cf, Hh, Hh, Gd^Es, Hh^Es, Gd, Hh, Ias, Ias^Es, Gd, Rp, Hh^Es, Ias^Es, Gd, Hh, Hh^Fp
Hh, Gd^Gvs, Gd^Es, Gd^Es, Gd, Ias, Rp, Gd, Gd, Gd^Es, Rp, Gd, Gd^Gvs, Gd^Gvs, Gd^Gvs, Gd^Gvs, Re, Cf, Xoa, Ias, Ias, Hh^Fp, Hh, Ias, Hh, Cf, Cf, Kf, Cf, Cf, Hh, Ias, Hh, Hh, Ias, Ias, Xoa, Cf, Hh, Hh, Gd, Ias^Es, Hh, Gd, Hh, Rp, Gd^Es, Hh^Es, Hh, Hh, Hh^Fp, Hh^Fp, Hh^Fp
Hh, Gd, Gd, Hh, Hh, Gd^Es, Gd, Rp^Es, Gd, Rp, Rp, Ias, Gd, Gd, Rp, Ias, Ias, Re, Rp, Rr^Pr\, Xoa, Ias, Hh, Ias, Hh, Cf, Hh, Cf, Hh, Cf, Hh, Ias, Ias, Ias, Xoa, Rr^Pr/, Rp, Gd, Rp, Gd, Gd, Rp, Hh^Fp, Hh^Fp, Hh, Hh, Hh^Es, Hh^Fp, Mm, Hh, Hh^Fp, Hh^Fp, Hh^Fp
Gg^Fp, Hh, Hh, Hh, Hh, Gd^Fp, Gd^Fp, Gd, Gd^Fp, Hh, Hh, Gs^Vc, Gd^Gvs, Re, Gd^Gvs, Gd, Gd, Rp, Re, Re, Ch, Ias, Hh, Ias, Ias, Hh, Ias, Ias, Ias, Hh, Ias, Ias, Hh, Ias, Ch, Rp, Re, Rp, Hh, Hh, Hh^Es, Hh, Hh, Hh^Fmw, Mm, Hh^Fmw, Mm, Mm, Mm, Mm, Mm, Mm, Mm
Mm, Hh^Fp, Mm, Mm, Hh, Hh^Fp, Gd^Fp, Hh^Fp, Hh, Hh^Fp, Hh, Gd^Gvs, Gd^Gvs, Gd^Fp, Hh, Gd^Fp, Hh^Fp, Re, Hh, Hh, Ch, Ias, Hh, Hh^Vhh, Hh, Ias, Hh^Fmf, Ias, Hh^Fmf, Ias, Hh, Hh^Vhh, Hh, Ias, Ch, Hh, Hh, Re, Re, Hh, Hh^Fp, Hh^Fp, Mm, Mm, Mm, Mm, Mm^Xm, Mm^Xm, Mm^Xm, Mm^Xm, Mm^Xm, Mm^Xm, Mm^Xm
Mm^Xm, Mm^Xm, Mm^Xm, Mm, Mm, Hh, Hh, Hh, Hh, Hh, Mm, Hh, Gd, Hh, Hh, Hh^Fp, Hh, Hh, Hh, Hh, Cf, Ias, Ias, Hh, Ias, Hh^Fmf, Ias, Ias, Ias, Hh^Fmf, Ias, Hh, Ias, Ias, Cf, Hh^Fmf, Hh, Re^Vhr, Gd, Hh, Hh, Hh, Mm, Mm, Mm^Xm, Mm^Xm, Mm, Mm^Xm, Mm, Mm^Xm, Mm^Xm, Mm^Xm, Mm^Xm
Mm, Mm^Xm, Mm, Mm^Xm, Mm^Xm, Mm^Xm, Mm, Mm, Mm^Xm, Mm, Mm, Hh, Hh, Gd, Hh^Edb, Rb^Edb, Hh, Hh, Hh^Fmf, Cf, Ch, Ias, Ch, Ias, Ch, Ias, Xos, Ias, Xos, Ias, Ch, Ias, Ch, Ias, Ch, Cf, Hh, Re, Re, Rb, Hh, Mm, Mm, Mm, Mm, Mm, Mm, Mm, Mm, Mm, Mm, Mm^Xm, Mm
Hh, Mm, Hh, Mm, Mm, Mm, Mm, Mm, Hh^Fmf, Mm, Hh^Fmf, Hh^Fmf, Hh, Gd, Hh^Edb, Cer^Edb, Hh^Edb, Re, Hh, Cf, Cf, Cf, Hh^Fmf, Ch, Hh, 3 Kh, Ias, Ias^Pr|, Ias, Kh, Hh^Fmf, Ch, Hh^Fmf, Cf, Cf, Cf, Hh, Gd, Ias, Cer^Edb, Hh, Hh^Fmw, Mm, Mm, Mm, Mm, Hh^Fp, Mm, Hh^Fp, Mm, Mm, Mm, Mm
Hh, Hh, Hh, Hh, Hh, Hh, Hh, Hh, Rd, Cer, Gd^Es, Hh, Gd^Es, Gd^Edb, Re^Edb, Rb^Dr, Cer, Re^Edb, Ias, Hh, Hh, Hh, Gd, Hh, Gd, Hh, Ias, Ias, Ias, Hh, Gd, Hh, Hh, Hh, Hh, Hh^Fmf, Gd, Re, Gd^Edb, Rb^Edb, Re^Edb, Hh, Hh, Mm, Mm, Mm, Hh^Fmf, Hh^Fmw, Cer, Hh^Fmf, Mm, Mm, Mm
Hh, Hh, Hh, Mm, Kd, Gd, Rd, Rd^Edt, Cer, Rd, Gd^Es, Gd^Es, Gd^Gvs, Gd^Edb, Re^Edb, Rb^Edb, Rb^Dr, Gd^Edb, Rb, Gd, Ias, Rb, Re, Gd, Ias, Gd, Ias, Ias, Ias, Gd, Ias, Gd, Rb, Ias, Ias, Gd, Rb, Re^Edb, Co^Edb, Rb^Dr, Re^Edb, Hh, Gd, Mm, Hh, Hh, Hh, Hh, Rd^Ecf, Hh^Fmf, Hh, Mm, Hh
Gd^Fmf, Gd^Fmf, Hh, Hh, Gd^Vct, Rd, Gd^Vct, Rd, Rd, Rd, Hh, Gd, Hh, Gd, Hh, Re^Edb, Re^Edb, Rb^Edb, Cer^Edb, Re^Edb, Gd^Edb, Gd, Gd^Edb, Rb, Gd^Edb, Re, Ias, Ias, Ias, Re, Gd, Re, Gd^Edb, Gd, Gd^Edb, Re, Cer^Edb, Rb^Dr, Re^Edb, Re, Gs^Edb, Gd^Edb, Gd, Hh^Es, Hh, Hh^Ecf, Hh, Cer, Hh, Rd^Edt, Kd, Hh^Fmf, Hh^Fmf
Gd^Fmf, Gd^Fmf, Gd^Fmf, Hh, Rd, Rd^Ecf, Hh, Hh, Hh, Cer, Mm^Xm, Hh, Hh^Fmf, Hh, Hh^Fmf, Gd, Gd^Es, Re^Edb, Re^Edb, Rb^Dr, Rb^Edb, Co^Edb, Cer^Edb, Rb^Dr, Rb^Edb, Cer^Edb, 2 Hhd^Dr, Ias^Edb, Hhd^Dr, Rb, Rb, Rb^Dr, Rb, Rb^Edb, Cer^Dr, Rb^Edb, Re^Edb, Re^Edb, Gd^Edb, Gs^Edb, Rb, Gd^Gvs, Gd^Gvs, Gd, Hh, Hh, Mm, Mm, Rd^Vct, Rd^Edt, Hh, Hh, Hh
Gd, Gd^Fmf, Cer, Rd, Rd, Gd^Edt, Hh, Mm, Mm, Mm, Mm^Xm, Mm, Hh^Fmf, Hh^Fmf, Hh, Hh, Gd^Gvs, Gd^Es, Gd^Edb, Re^Edb, Re^Edb, Re^Edb, Re^Edb, Re^Edb, Re^Edb, Re^Edb, Re^Edb, Rr^Pw|o, Re^Edb, Co^Edb, Re^Edb, Re^Edb, Re^Edb, Co^Edb, Re^Edb, Re^Edb, Gs^Edb, Gd^Edb, Gs^Es, Gs^Gvs, Gs^Gvs, Gd^Gvs, Gd, Gd^Es, Cer, Mm, Mm, Mm, Rd^Edt, Rd^Edt, Hh, Hh, Hh
Gd, Gd, Rd, Rd, Gd^Vct, Hh^Fmf, Hh, Hh^Fmf, Hh^Fmf, Hh^Fmf, Mm^Xm, Mm^Xm, Cer, Hh^Fmf, Hh, Hh, Hh, Gd^Es, Gs^Es, Gd^Gvs, Gs^Gvs, Gd, Gs^Gvs, Gd, Gd^Gvs, Gd^Edb, Gd, Ias^Edb, Ias, Gd^Edb, Gd^Gvs, Gd, Gd, Gd^Edb, Gs, Gs^Es, Gs^Gvs, Gs^Gvs, Gs, Gs^Gvs, Gs^Gvs, Gd, Cer, Hh, Rd, Mm, Hh, Hh^Fmf, Hh, Mm, Hh, Hh, Hh
Gd, Gs, Cer, Rd, Rd, Hh, Gd, Hh^Fmf, Hh, Hh^Fmf, Mm, Mm, Rd, Hh, Rd, Gd, Gd, Gd, Gd, Gs, Gd^Es, Gs^Gvs, Gd, Rb, Gs^Gvs, Gs^Gvs, Gs, Ias, Ias, Gd, Gs^Gvs, Gd^Gvs, Rb, Gs^Gvs, Gs^Gvs, Gs, Gs^Gvs, Gs^Gvs, Rb, Gs, Gd^Es, Gd^Es, Hh, Re, Hh^Fmf, Hh, Rd^Vct, Hh, Rd, Hh, Hh^Fmf, Hh^Fmf, Hh^Fmf
Gd^Fmf, Gd^Fmf, Gd^Fmf, Rd^Edt, Rd^Edt, Gd, Gd^Vct, Hh, Hh, Mm, Mm, Hh^Fmf, Hh, Cer, Hh, Rd^Es, Rd, Gd, Cer, Rd, Cer, Rd, Cer, Gd, Gd, Gs^Gvs, Gd, Ias, Ias, Gs, Gs^Es, Gs^Gvs, Gs^Gvs, Gs^Gvs, Gs, Gs, Gs^Gvs, Gs^Gvs, Gd^Gvs, Gd^Gvs, Cer, Gd^Es, Hh, Rd, Hh, Rd, Rd^Edt, Rd^Edt, Hh, Hh, Hh^Fmw, Hh^Fmf, Hh^Fmf
Hh, Hh^Fmf, Gd^Fmf, Gd, Rd, Rd, Rd^Ecf, Rd, Rd^Edt, Gd^Edt, Hh, Hh^Fmf, Hh^Fmf, Mm, Hh, Cer, Rd, Rd, Rd, Hh, Hh^Fmf, Hh, Hh, Rd, Cer, Gd^Es, Cer, Gs, Cer, Ias, Cer, Gs, Cer, Gs, Cer, Gd^Es, Cer, Gd^Es, Cer, Gd, Rd, Hh, Hh, Mm, Hh^Fmf, Rd^Vct, Rd^Edt, Gd^Ecf, Gd, Hh, Hh^Fmf, Hh^Fmw, Hh
Hh, Hh, Hh, Hh, Gd, Rd^Vct, Hh, Rd, Rd^Edt, Gd, Hh, Gd^Fmw, Gd, Hh, Hh^Fmf, Rd, Rd^Edt, Rd, Hh, Hh, Hh, Hh, Rd, Rd, Hh, Rd, Rd, Rd, Ias, Ias, Ias, Rd, Rd, Rd, Rd, Rd, Rd, Gd, Rd, Rd, Hh, Rd, Hh, Hh^Fmf, Rd^Fmw, Hh, Hh, Rd, Gd^Edt, Hh, Gd, Hh, Gd^Fmw
Hh, Hh, Hh^Fmf, Hh^Fmf, Hh^Fmw, Gd^Fmf, Hh, Gd^Edt, Rd, Rd^Edt, Rd, Gd^Vct, Rd^Ecf, Gd^Edt, Rd^Vct, Rd^Edt, Rd^Edt, Rd^Edt, Rd^Edt, Rd^Edt, Rd^Edt, Rd, Gd^Edt, Rd, Rd^Edt, Rd^Edt, Rd^Edt, Rd^Edt, Ias, Rd, Ias, Rd, Rd^Edt, Rd, Rd^Edt, Rd, Rd^Edt, Rd, Rd^Edt, Rd, Rd^Edt, Rd, Rd, Rd, Rd^Edt, Rd, Rd, Rd^Edt, Gd, Cer, Gs, Gd^Fmf, Gd
Mm^Xm, Mm, Mm, Hh^Fmf, Hh^Fmw, Hh^Fmw, Hh^Fmf, Hh, Gd, Rd^Edt, Rd, Rd, Rd, Rd, Rd, Rd, Gd, Rd^Edt, Cer, Rd^Edt, Rd^Edt, Rd^Edt, Gd^Edt, Gd^Edt, Gd^Edt, Rd^Edt, Rd^Edt, Rd^Edt, Rd^Edt, Ias, Ias, Rd^Edt, Rd^Edt, Rd^Edt, Rd^Edt, Rd^Edt, Rd^Edt, Rd^Edt, Rd^Edt, Rd^Edt, Rd, Rd^Edt, Gd, Gd^Vct, Gs, Gs^Edt, Gs, Gs^Vct, Rd, Rd^Edt, Gs^Edt, Gs^Edt, Gd
Mm^Xm, Mm^Xm, Mm, Hh^Fmf, Hh^Fmf, Hh^Fmw, Hh^Fmw, Hh, Gd^Fmf, Gd^Edt, Gd^Edt, Gd^Vct, Gd^Edt, Gd^Ecf, Gd^Vct, Gd, Cer, Cer, 1 Kd, Cer, Cer, Rd^Edt, Rd^Edt, Rd^Vct, Rd, Rd^Vct, Rd, Rd^Vct, Gd, Ias, Ias, Ias, Rd, Rd^Vct, Rd, Rd^Vct, Gd, Rd^Vct, Gd, Gd, Rd, Gd^Vct, Rd, Gd^Ecf, Rd, Rd^Vct, Gd, Rd, Gd^Edt, Rd^Edt, Cer, Gd, Hh
Hh, Mm^Xm, Mm^Xm, Mm, Mm, Hh^Fmw, Hh^Fmf, Hh, Gd^Fmf, Gd^Fmf, Gs^Fmw, Gs^Fmw, Gs, Gd, Hh^Fmf, Hh, Hh, Cer, Cer, Cer, Rd, Rd^Edt, Gd, Gd^Ecf, Gd, Rd^Ecf, Rd, Gd^Ecf, Rd, Gd^Vct, Ias, Ias, Rd, Rd^Ecf, Rd, Rd^Ecf, Rd, Gd^Ecf, Rd, Gd^Vct, Rd^Edt, Rd^Edt, Gd^Edt, Rd^Vct, Gd^Edt, Rd^Edt, Gd^Fmf, Gd, Gd, Gd, Gd, Hh, Hh^Fmf
Hh, Mm, Mm, Hh, Hh, Hh, Hh^Fmf, Hh, Hh^Fmf, Gs^Fmf, Gs^Fmw, Gs^Fmw, Gs^Fmf, Gs^Fmf, Hh^Fmf, Hh, Hh, Hh, Hh, Hh^Fmf, Hh, Hh, Gd, Gd^Vct, Gd, Rd^Vct, Rd, Rd^Vct, Rd, Rd, Rd, Ias, Ias, Rd^Vct, Rd, Rd^Vct, Gd, Rd^Vct, Gd, Gd^Edt, Gd, Gd, Gd^Fmf, Gd^Edt, Gd^Fmf, Gd, Hh^Fmf, Gd^Fmf, Hh^Fmw, Gd^Fmw, Gd^Fmf, Hh^Fmf, Hh^Fmf
Hh, Hh, Hh, Hh, Hh, Hh^Fmf, Hh, Hh^Fmf, Hh, Gs^Fmf, Gs, Gs^Fmf, Gd, Gs^Fmf, Gd, Hh, Hh, Hh, Hh, Hh, Hh, Gd, Hh, Gd, Gd, Gd, Gd, Gd, Rd, Rd, Ias, Ias, Gd, Ias, Gd, Gd, Gd, Gd, Hh, Gd, Hh, Gd, Hh^Fmf, Gd^Fmf, Gg, Hh^Fmf, Gg, Hh^Fmw, Gg, Hh^Fmw, Hh, Hh^Fmf, Hh
