Gg, Gg, Gg, Gg, Re, Gg, Gg, Gg, Gs, Hh, Hh, Hh, Mm, Mm, Mm^Xm, Mm^Xm, Mm^Xm, Mm^Xm, Mm^Xm, Mm, Mm, Mm, Mm^Xm, Mm, Mm^Xm, Mm, Mm, Mm, Mm, Mm, Mm, Mm, Hh, Mm, Mm, Hh, Hh^Es, Hh, Gd, Gg, Hh, Hh, Hh, Hh, Hh, Hh, Mm, Gg, Mm, Gg, Mm, Mm, Mm, Mm, Mm, Hh, Hh^Fmw, Hh^Fmw, Hh^Fmw, Hh^Fmw, Hh^Fmw, Hh^Fmw, Mm, Hh^Fmw, Mm, Mm
Gll^Fp, Gll^Fp, Gg, Gg, Re, Gg^Efm, Gg^Efm, Gs, Gs^Es, Hh, Gll^Fmw, Hh, Hh^Fmw, Mm, Mm, Mm^Xm, Mm^Xm, Mm^Xm, Mm, Mm, Mm, Mm, Mm, Mm^Xm, Mm, Mm^Xm, Mm, Mm, Hh^Fmw, Mm, Hh, Mm, Hh, Mm, Mm, Hh, Hh, Gd, Gd, Hh, Hh, Hh, Hh, Hh, Mm, Mm, Mm, Mm, Mm, Mm, Mm, Mm, Hh, Mm, Hh, Hh^Fmw, Hh^Fmw, Hh^Fmw, Hh^Fmw, Hh^Fmw, Hh^Fmw, Mm, Mm, Mm, Mm, Mm
Gll^Fp, Gll^Fp, Gll^Fp, Gg^Efm, Gg^Efm, Re, Gg^Efm, Gs^Efm, Gs, Gll^Fp, Gll^Fp, Hh, Hh^Fp, Hh^Fp, Mm, Mm, Mm^Xm, Mm^Xm, Mm, Mm, Mm, Mm, Mm, Mm, Mm, Mm^Xm, Mm^Xm, Mm, Hh^Fmw, Hh^Fmw, Mm, Hh, Hh^Feth, Hh, Hh, Hh, Gd, Gd, Gs^Es, Hh, Hh, Hh, Mm, Mm, Mm, Mm, Mm, Mm, Mm, Mm, Mm, Mm, Hh, Hh, Hh^Fmw, Mm, Gll^Fp, Gll^Fp, Hh^Fmw, Gll^Fp, Mm, Mm, Mm, Mm, Mm, Mm
Gll^Fp, Gll^Fp, Gll^Fp, Gll^Fp, Gg^Efm, Re, Re, Gg, Re^Vct, Re, Ce, Hh, Hh, Hh^Fp, Mm, Mm, Mm^Xm, Mm^Xm, Mm, Mm, Hh, Hh, Hh^Fmw, Hh^Fp, Mm, Mm, Mm^Xm, Mm, Mm, Hh^Fmw, Hh, Hh, Hh^Fmw, Gd^Es, Gd^Es, Gd^Es, Gd, Gd, Hh, Hh, Hh, Hh, Mm, Mm, Mm, Mm, Mm, Mm, Mm, Mm, Hh, Hh, Hh^Fmw, Hh^Fmw, Hh^Fmw, Hh^Fmw, Gll^Fp, Gll^Fp, Hh^Fmw, Hh^Fmw, Mm, Mm, Hh^Fmw, Mm, Mm, Mm
Gll^Fp, Gll^Fp, Gll^Fp, Gll^Em, Gs, Gg, Re^Vct, Re^Vct, Ce, Re^Vct, Ce, Re^Vct, Hh, Hh, Mm, Mm, Mm^Xm, Mm, Mm, Hh, Hh, Mm, Hh, Hh^Fmw, Mm, Mm, Mm, Mm^Xm, Mm, Mm, Mm, Mm, Hh^Fds, Hh, Hh, Hh, Gs, Gs, Hh, Hh, Mm, Mm, Mm, Mm, Mm, Mm, Mm, Mm, Mm, Hh, Hh, Hh^Fmw, Hh^Fmw, Hh^Fmw, Hh^Fmw, Hh^Fmw, Hh, Hh^Fmw, Hh^Fmw, Mm, Hh^Fmw, Hh^Fmw, Gll^Fp, Mm, Hh^Fmw, Hh^Fmw
Gll^Fp, Gll^Fp, Gll^Fp, Gll^Fp, Gll^Fp, Re, Re^Vct, Ce, 2 Ke, Ce, Re, Ce, Hh, Hh^Fp, Hh^Fmw, Mm, Mm, Mm^Xm, Mm, Hh^Fmw, Hh^Fp, Mm, Mm, Hh, Hh, Mm, Mm, Mm, Mm, Mm, Mm, Mm, Mm, Hh, Hh, Gs, Gs, Gd, Hh, Hh, Mm, Mm, Mm, Mm, Mm, Mm, Mm, Mm, Hh, Hh, Hh, Hh^Fmw, Hh, Hh^Fmw, Hh, Hh, Hh, Hh^Fmw, Hh^Fmw, Hh^Fmw, Hh^Fmw, Gll^Fp, Hh^Fmw, Hh, Hh^Fmw, Hh^Fmw
Gll^Fp, Gll^Fp, Gll^Fp, Gll^Fp, Re, Ce, Ce, Ce, Ce, Ce, Re, Re, Gs^Es, Hh, Hh, Mm, Mm, Mm^Xm, Mm, Hh^Fmw, Hh^Fmw, Hh, Hh^Fmw, Hh, Mm, Hh, Hh^Dr, Mm, Mm, Hh^Fp, Hh^Fmw, Hh, Hh, Hh, Gd^Vc, Gd, Gs, Hh, Hh, Mm, Hh, Hh, Gd, Hh, Mm, Mm, Hh, Mm, Gd, Gd, Hh, Hh, Mm, Mm, Mm, Hh^Fmw, Hh^Fmw, Hh, Hh, Hh, Hh, Hh^Fmw, Hh, Hh, Hh, Hh
Gll, Gll^Fp, Gs^Fms, Gll, Re, Re^Vct, Ce, Re, Re, Re, Gg^Efm, Gg, Gs, Hh, Hh, Hh^Fp, Mm, Mm^Xm, Mm, Mm, Hh, Mm, Hh, Hh, Hh, Hh, Hh, Hh, Hh, Hh^Fmw, Hh^Fds, Hh^Fmw, Hh, Hh, Gs^Es, Gd, Hh, Hh, Hh, Mm, Hh, Gd, Gd, Hh, Mm, Mm, Hh, Hh, Gd, Hh, Mm, Mm, Mm, Mm, Mm, Mm, Mm, Mm, Hh^Fmw, Hh, Hh, Hh, Mm, Mm, Mm, Hh
Gll, Gll^Em, Gll^Fp, Gll^Em, Gll^Fp, Re, Re, Re, Gg^Efm, Re, Gg^Efm, Gs^Efm, Gs^Es, Gd^Es, Hh, Hh, Mm, Mm, Mm, Mm, Hh^Fp, Gd^Fmw, Gd^Es, Gd^Es, Gs, Gd^Es, Hh, Hh, Hh^Fds, Hh^Fmw, Gs^Fmw, Hh, Gs^Es, Gs, Gs, Gs, Hh, Hh, Hh^Fmw, Hh, Hh, Hh, Hh, Hh^Fmw, Hh, Hh, Hh, Gs, Hh, Hh^Fmw, Hh^Fmw, Mm, Mm, Mm, Mm, Mm, Mm, Mm, Hh^Fmw, Hh^Fmw, Hh^Fmw, Mm, Hh, Mm, Hh, Hh
Gll^Fp, Gll^Fp, Gll^Fp, Gll^Fp, Gs^Fms, Gll^Fp, Gll^Fp, Gg, Gll, Re, Re, Gll^Gvs, Gll^Gvs, Hh, Hh, Hh^Fp, Hh^Fp, Mm, Mm, Hh^Fp, Hh^Fmw, Hh^Fmw, Gs^Fds, Gs, Hh, Gs, Gs, Gs^Es, Gs, Hh, Gs^Es, Gs, Hh, Hh, Gs, Gs, Gs^Fds, Hh^Fmw, Gll^Fp, Hh, Hh^Fp, Hh^Fmw, Gll^Fp, Hh, Hh^Fp, Hh^Fmw, Gll^Fp, Gs, Gll^Fp, Gll^Fp, Mm, Mm, Mm, Mm, Mm, Mm, Mm, Mm, Mm, Hh^Fmw, Hh^Fmw, Hh, Hh^Fmw, Hh, Hh, Hh
Gll^Fp, Gll^Fp, Gs^Fms, Gs^Fds, Gs^Fms, Gll^Fp, Gll^Fp, Gll^Fp, Gg, Gll^Gvs, Re, Gll^Gvs, Gll^Gvs, Hh, Gs, Hh^Fp, Hh, Hh^Dr, Hh, Hh, Gs^Fds, Hh, Gs^Es, Hh, Hh, Gs, Gs, Hh^Es, Gs, Gs, Gg, Gs, Gs, Gs, Gg^Efm, Gs, Gs, Gs^Fms, Gll^Fp, Gll^Fmw, Gs^Fms, Gs^Fms, Gll^Fp, Gll^Fmw, Gs^Fms, Gs^Fmw, Gs^Fms, Gs^Fms, Gs^Fms, Gs^Fms, Gs^Fms, Mm, Gs^Fms, Gll^Fmw, Mm, Mm, Mm, Mm, Mm, Mm, Mm, Mm, Mm, Mm, Mm, Mm
Gll^Fp, Gll^Fp, Gll^Fp, Gs^Fms, Gll, Gll^Em, Gll^Em, Gll, Gll^Fp, Gll^Gvs, Re, Gs^Vh, Gll^Gvs, Gll^Gvs, Gll^Gvs, Hh, Gs, Hh, Gs, Hh, Gs^Es, Gs, Hh, Gs, Gg^Efm, Gg, Gs^Efm, Gs^Efm, Gg^Efm, Gg, Re, Gg, Re, Gg, Gg^Efm, Gg^Efm, Gs, Gs^Fms, Gs^Fms, Gs^Fms, Gs^Fms, Gs^Fmw, Gs^Fms, Gs^Fms, Gs^Fms, Gs^Fms, Wwf, Wwg, Wog, Wwg, Wog, Wwg, Wwg, Gs^Fms, Gll^Fp, Gll^Fp, Gll^Fp, Mm, Mm, Mm, Mm, Mm, Mm, Mm, Mm, Mm
Gll, Gll^Fp, Gll^Fp, Gll^Fp, Gll, Gll^Fp, Gs^Fms, Gs^Fds, Gs^Fms, Gll^Gvs, Gll^Gvs, Re, Re, Gll^Gvs, Gll^Gvs, Gs, Gs^Efm, Hh, Gs, Gs, Gg^Efm, Gs, Gs, Gs, Gg^Efm, Gg^Efm, Gg^Efm, Gg, Gg, Re, Ce, Re^Vct, Ce, Re, Re, Gg^Efm, Gg, Gg, Gg, Gg, Gg, Gs^Fms, Gg, Gg^Efm, Gg^Efm, Gg^Efm, Gg^Efm, Wwg, Wwg, Wog, Wwg, Wog, Gs^Fms, Gs^Fms, Gll^Fp, Gll^Fp, Mm, Mm, Mm, Mm, Mm, Mm, Mm, Mm, Mm, Mm
Gll, Gll^Em, Gll^Fp, Gll^Fp, Gll^Fp, Gs^Fms, Gs^Fms, Gs^Fms, Gs^Fms, Gs^Fms, Gll^Gvs, Gll^Gvs, Re, Gll^Gvs, Gll^Gvs, Gg^Efm, Gs^Efm, Gs, Ch, Gg^Efm, Gg^Efm, Gs, Chr, Gg, Gg, Gg^Efm, Re, Re, Re, Re, Re, Ce, 1 Ke, Ce, Re^Vct, Gg^Efm, Gg, Gll^Edt, Gll^Edt, Gll^Edt, Gll^Gvs, Gg, Gll^Edt, Gg, Gg, Gg^Efm, Gs^Fms, Gs^Fms, Gs^Fms, Gs^Fms, Gs^Fds, Gll^Fp, Gll^Fp, Mm, Mm, Mm, Mm, Mm, Mm, Mm, Mm, Mm, Hh, Mm, Mm, Mm
Gll^Fp, Gll^Fp, Gll^Fp, Gs^Fms, Gll, Gll^Fp, Gll^Fp, Gll^Fp, Hh^Fp, Gll^Fp, Hh^Fp, Gs, Gg, Re, Re, Gg, Re, Gg, Kh, Gg, Re, Re, Khr, Re, Re, Re, Gs, Gg^Efm, Gg^Efm, Gg, Re^Vct, Ce, Ce, Ce, Re, Gg, Gg, Gll^Gvs, Re, Gd^Vhr, Gll^Edt, Gll^Gvs, Gll^Edt, Gg, Gg, Gg, Gg, Gs^Fds, Gg^Efm, Gs^Fms, Gs^Fms, Gs^Fms, Gs^Fms, Mm, Hh, Mm, Hh, Mm, Hh, Mm, Hh, Mm, Hh, Hh, Hh, Mm
Gll^Fp, Gll^Fp, Gll^Fp, Gll^Em, Gll, Gll^Fp, Gll^Fp, Hh^Fp, Hh^Fp, Hh^Fp, Hh, Gll^Fp, Gs, Gg^Efm, Gs^Efm, Re, Gg, Re, Ch, Re, Gg^Efm, Gs, Chr, Gll^Edt, Gg^Vhr, Gll^Edt, Hh, Gs^Efm, Gs^Efm, Gg^Efm, Gg^Efm, Re, Re, Re, Gg^Efm, Re, Re, Re, Gll^Edt, Re, Re, Gll^Edt, Gg, Gll, Gll^Gvs, Gll, Gll^Edb, Gg, Gg, Gs^Fms, Gs^Efm, Hh, Hh, Gs^Fms, Hh, Hh, Hh, Hh, Hh, Hh, Rb, Hh, Hh, Hh, Hh, Hh
Hh^Fp, Gll^Fp, Gll^Fp, Gll^Fp, Gll^Fp, Gll^Fp, Gll^Es, Hh^Fp, Gll^Fp, Hh^Fp, Hh^Fp, Hh^Fp, Gd, Gs^Efm, Gd, Gs, Gs^Efm, Gg, Gs, Gg^Efm, Gs^Efm, Gs, Hh, Gll^Edt, Gll^Edt, Gll^Gvs, Hh, Hh, Gs, Gg^Efm, Gs, Gs, Gs, Gg^Efm, Gs^Efm, Gg^Efm, Gs, Gll^Edt, Gll^Edt, Gll^Gvs, Gg, Re, Gg, Gll^Gvs, Gll^Gvs, Gll^Edb, Gg^Edb, Gg, Gg, Gg, Gg, Gs, Gs, Hh, Hh, Hh, Cer, Rb^Edb, Rb^Edb, Rb, Cd, Rb, Hh, Hh^Fms, Hh, Hh^Fms
Hh^Fp, Hh^Fp, Hh^Fp, Gll^Fp, Hh^Fp, Gll^Fp, Gll^Fp, Gll^Fp, Hh^Fp, Gll^Fp, Gll, Gll, Gd, Hh, Hh, Hh, Gs, Hh, Gs, Gs, Gs, Hh, Gs, Hh, Hh, Hh, Hh, Gs^Es, Gs, Gs, Gd^Es, Hh, Hh, Gs, Hh, Gs, Hh, Gs, Gg, Gll^Edt, Re, Re, Gll^Es, Gll^Edb, Gll^Gvs, Gll^Gvs, Gll, Gg, Gll^Edb, Gll^Gvs, Gll^Edb, Gll^Edb, Gs, Hh, Rb, Hh, Rb, Rb^Edb, Rb^Ecf, Rb^Edb, Cd, Rb^Edb, Rb^Edb, Gd^Fms, Hh^Fms, Hh^Fms
Hh^Fp, Hh^Fp, Hh^Fp, Hh^Fp, Gll^Fp, Gll^Fp, Hh^Fp, Hh^Fp, Hh^Fp, Hh^Fp, Hh, Gll^Fp, Gd, Gd, Gd, Gd, Gd^Es, Gd^Es, Hh, Gd^Es, Hh, Gs^Es, Gs, Hh, Gd, Hh, Gd^Es, Gd, Gd, Gs, Hh, Hh, Gd^Es, Hh^Fmw, Hh^Fmw, Hh^Fmw, Hh, Gs, Re, Re, Gll^Gvs, Re, Re, Gg, Gll, Gll^Edb, Gg, Gll^Gvs, Gg^Edb, Gll^Edb, Gll^Gvs, Gll^Edb, Gg, Gd, Rb, Cer, Rb^Edb, Gd, Rb, Cd, 3 Kd, Cd, Rb^Edb, Gd^Edb, Gd^Fms, Hh^Fms
Hh, Hh^Fp, Hh^Fp, Gll^Fp, Gll^Fp, Gll^Fp, Hh, Hh, Gll^Fp, Hh, Gd^Es, Gll^Es, Hh, Gs, Gd^Es, Hh, Hh, Gd^Es, Hh, Hh, Hh, Hh, Chr, Gd, Hh, Gs^Es, Gs^Es, Gd, Gs, Gs, Gd, Gs^Es, Gs, Gd, Gs, Hh, Gs, Gs, Re, Gll^Edb, Gll^Edb, Gll^Gvs, Gg^Edb, Re, Re, Re, Re^Es, Gg, Gd^Vhr, Gg, Re, Gg, Gs, Gd, Rb, Rb^Edb, Gd^Edb, Gd, Rb^Ecf, Cd, Cd, Cd, Rb^Edb, Gd^Edb, Gd, Gd
Gll^Fp, Hh, Gll, Gll^Fp, Gll, Hh^Fp, Hh, Gll, Hh, Hh, Gs, Gd^Es, Gd, Gd^Es, Hh, Gd^Es, Hh, Hh, Hh, Hh, Mm, Hh, Hh, Hh, Hh, Hh, Hh, Hh, Gs^Es, Gs^Es, Hh, Gs^Es, Gs^Es, Gs, Gg, Gs, Re, Re, Gs, Gll, Gs, Gll^Edb, Gll^Edt, Gll^Gvs, Gd^Vhr, Gg, Gg, Re, Re, Re, Gg, Re, Re, Re, Re, Cer, Rb, Gd, Gd^Vct, Rb, Cd, Rb, Gd^Vct, Gd, Gd, Gg
Gll^Fp, Gll^Fp, Gll, Gd, Gd, Gll^Fp, Gs, Gd^Es, Hh, Hh, Gd^Es, Gd, Hh, Hh, Hh, Hh, Hh^Fdw, Mm, Mm, Hh, Hh, Hh, Hh, Mm, Mm, Mm, Hh, Hh, Hh, Gs, Hh, Gs^Es, Hh, Gd, Re, Re, Gd, Gg, Gs, Hh, Gg, Gg, Gll^Edt, Gll^Edt, Gll^Gvs, Gll^Gvs, Gll^Edt, Gg, Gg, Gg, Rb, Gd, Rb, Rb, Cer, Re^Edb, Re^Edb, Gd, Gd, Rb, Rb, Rb, Gd, Gg, Gg, Gg
Gd, Gll^Es, Hh, Hh, Hh, Gd, Gd, Gd, Ch, Gd^Es, Hh, Gd^Es, Hh, Mm, Mm, Hh, Mm, Mm, Mm^Xm, Mm, Mm, Hh^Fdw, Hh, Mm, Hh^Es, Hh, Hh, Hh, Mm, Hh, Hh, Hh, Hh, Chr, Gd, Chr, Gd, Hh, Hh, Gs, Gd, Gg, Gg, Gll^Edt, Gg, Gll^Edt, Gg, Gs, Rb, Gd, Cer, Gd, Cer, Rb, Rb^Edb, Rb^Edb, Re, Gd^Vct, Gd, Gd^Vct, Rb, Gg^Vct, Gg, Gg, Gg, Gg
Gd, Gd^Es, Hh^Fp, Gd, Gs^Es, Gd^Es, Hh, Hh, Gd, Hh, Mm, Hh, Hh, Mm, Mm, Hh^Fdw, Mm, Mm, Mm^Xm, Mm, Mm, Hh^Fdw, Hh, Hh, Gd^Es, Gd^Es, Hh, Mm, Hh, Mm, Hh, Hh, Hh, Hh, Gd, Hh, Hh, Hh, Mm, Hh, Gd, Gg, Hh, Gg, Gs, Gs, Gs, Rb, Cer, Rb, Rb^Edb, Rb^Edb, Rb^Edb, Rb^Edb, Gd^Vct, Gd^Edb, Rb, Re^Edb, Re^Edb, Rb^Edb, Re^Edb, Rb^Edb, Gd, Chr, Gd, Gg
Hh, Hh, Hh, Hh, Gs, Gs^Es, Gd, Hh, Hh, Mm, Mm, Hh, Hh^Fdw, Hh^Fdw, Mm, Mm, Mm^Xm, Mm^Xm, Mm, Mm, Mm, Mm, Hh^Fdw, Hh, Hh, Gd, Hh, Hh, Hh, Hh, Mm, Mm, Hh, Hh, Gd, Hh, Mm, Mm, Mm, Mm, Hh, Gd, Hh, Gs, Hh, Gs, Rb, Gd, Rb, Rb, Rb^Vct, Rb^Ecf, Rb^Vct, Rb, Rb, Rb, Gd, Rb, Gd, Re, Gd, Re, Re, Re, Re, Re
Hh, Hh, Hh, Hh, Gd, Hh, Hh, Hh, Hh, Hh^Fdw, Mm, Hh, Mm, Mm, Mm, Mm^Xm, Mm^Xm, Mm^Xm, Mm, Mm, Mm, Mm, Hh, Hh, Mm, Hh, Mm, Hh, Mm, Hh^Fdw, Mm, Mm, Hh, Hh, Hh, Gd, Hh, Mm, Mm, Mm, Mm, Hh, Hh, Hh, Hh, Hh, Hh, Cer, Rb^Edb, Rb^Ecf, Cd, Cd, Cd, Cd, Rb, Gd^Vct, Gd, Gs^Vct, Gd, Gs^Vct, Gs, Re^Vct, Gg, Chr, Gg, Gd
Gd, Gd^Es, Gd^Es, Gd, Hh, Hh, Mm, Hh, Hh, Hh, Mm, Mm, Mm, Mm, Mm^Xm, Mm^Xm, Mm^Xm, Mm, Mm, Mm, Mm, Hh, Mm, Mm, Mm, Mm, Mm, Mm, Mm^Xm, Mm, Mm, Mm, Mm, Mm, Gd, Gd, Hh, Hh, Hh, Mm, Mm, Hh, Hh, Hh, Hh, Hh, Gd, Rb, Rb, Rb^Vct, Cd, 4 Kd, Cd, Rb, Gs, Hh, Hh, Hh, Hh, Hh, Gd^Fms, Gs, Gs^Fms, Gg, Gg, Gg
Hh, Hh, Hh, Hh, Mm, Mm, Mm, Hh, Mm, Mm, Mm, Mm, Mm, Mm, Mm^Xm, Mm^Xm, Mm, Mm, Mm, Mm, Hh, Hh, Hh, Mm, Mm, Mm^Xm, Mm^Xm, Mm^Xm, Mm^Xm, Mm, Mm, Mm, Gd, Gd, Mm, Hh, Mm, Hh, Mm, Hh, Hh, Hh, Hh, Hh, Mm, Hh, Hh, Gs, Rb, Cd, Rb, Cd, Rb, Rb, Gd, Hh, Hh, Hh, Hh^Fms, Hh, Hh^Fms, Hh, Hh^Fms, Gs^Fms, Gg^Fms, Gs
Hh, Hh, Hh^Fdw, Hh, Hh, Mm, Hh, Mm, Mm, Mm, Mm^Xm, Mm, Mm^Xm, Mm^Xm, Mm^Xm, Mm^Xm, Mm, Mm, Mm, Hh, Mm, Mm, Mm, Mm, Mm^Xm, Mm^Xm, Mm^Xm, Mm^Xm, Mm, Mm, Mm, Hh, Gd, Mm, Mm, Mm^Xm, Mm^Xm, Mm, Mm, Hh, Hh, Hh, Hh, Mm, Mm, Hh, Hh, Hh, Gd, Rb, Gs, Rb, Gs, Gs, Hh, Hh, Hh, Hh^Fms, Hh^Fms, Hh^Fms, Hh, Hh^Fms, Hh, Gd^Fms, Gs^Fms, Gs^Fms
Hh^Fdw, Hh^Fdw, Hh^Fdw, Mm, Hh, Hh, Mm, Mm, Mm, Mm, Mm^Xm, Mm^Xm, Mm^Xm, Mm^Xm, Mm, Mm, Mm, Mm, Mm, Hh, Mm, Mm, Mm, Mm, Mm, Mm^Xm, Mm, Mm, Mm, Mm, Mm, Gg, Mm, Mm, Mm, Mm^Xm, Mm, Mm, Mm, Hh, Hh, Hh, Hh, Mm, Mm, Mm, Hh, Hh, Gg, Gs, Gg, Gs, Gg, Hh, Gg, Hh, Hh, Hh^Fms, Hh, Hh^Fms, Hh, Hh, Hh, Hh, Hh, Hh
