Gll^Fmw, Gs^Fms, Gs^Fms, Gs^Fms, Gs^Fms, Gll^Fp, Hh^Fp, Gg, Mm, Mm, Mm, Mm^Xm, Mm^Xm, Mm^Xm, Mm^Xm, Mm, Mm, Mm, Mm, Gg, Mm, Gg, Mm, Gg, Gll^Fmw, Gll^Fmw, Gs^Fms, Gg, Gs^Fms, Gg, Gll^Fmw, Gll^Fmw
Gll^Fmw, Gll^Fmw, Gs^Fms, Gs^Fms, Hh, Gll^Fp, Gll^Fp, Hh, Hh, Mm, Mm, Mm^Xm, Mm^Xm, Mm^Xm, Mm, Mm, Mm, Mm, Mm, Mm, Hh, Mm, Hh, Hh, Gll^Fmw, Gll^Fmw, Gs^Fds, Gs^Fms, Gs^Fms, Gs^Fms, Gll^Fp, Gll^Fmw
Gs^Fms, Gs^Fms, Gs^Fms, Gs^Fms, Hh, Hh, Gd^Es, Hh, Hh^Fp, Hh, Hh, Mm, Mm^Xm, Mm, Hh, Hh, Hh, Hh, Hh, Hh, Hh^Fp, Hh^Fp, Hh, Hh, Gll^Fp, Gs^Fms, Gs^Fms, Gs^Fms, Gll^Fp, Gs^Fms, Gd, Gll^Fp
Gll^Fp, Gs^Fms, Gs^Fms, Hh, Hh, Hh, Gd^Es, Gd^Es, Hh^Fp, Hh, Hh, Mm, Mm^Xm, Mm^Xm, Mm, Hh, Hh^Fp, Gll^Fmw, Gs^Fms, Gs^Fms, Gs^Fds, Gs^Fms, Gs^Fms, Gs, Gd, Gd, Gd^Es, Gd, Hh, Gd^Es, Gd^Es, Hh
Gll^Fp, Gll^Fp, Ss, Gd^Es, Hh, Hh, Gd, Gd, Hh, Hh, Hh, Mm, Mm, Mm^Xm, Mm, Hh, Hh, Gll^Fp, Gll^Es, Gs^Fms, Gs^Fms, Gs^Fms, Gs^Efm, Gs^Efm, Gll^Fp, Hh, Hh, Hh, Hh, Hh, Hh, Hh
Gs^Fms, Gs^Fms, Hh, Hh, Hh, Gd, Gd, Hh, Hh, Gll^Fmf, Gs^Fms, Hh^Fp, Hh, Mm, Mm, Mm, Hh, Hh, Hh, Hh, Hh, Gs, Gs^Fms, Gs, Gs^Fds, Hh, Gll^Fmw, Hh, Hh, Hh, Hh, Hh
Gs^Fms, Gs^Fms, Gs^Fms, Hh, Gll^Fp, Gll^Fp, Gs^Fms, Hh, Gll, Gll^Em, Gll^Fmw, Gs^Fms, Hh, Mm, Mm, Mm, Mm, Mm, Mm, Hh, Hh, Gs^Es, Gs^Fms, Gs^Fds, Gs^Fds, Gs^Fms, Gll^Fp, Gs^Fms, Gs^Fms, Gs^Fms, Gs^Fds, Gll^Fp
Gg, Gs^Fds, Gs^Fms, Gll^Fmw, Gs^Fms, Gs^Fms, Gs^Fms, Gll^Fp, Gs^Fms, Ss, Gs^Fms, Hh, Hh, Mm, Hh, Hh, Hh, Mm, Hh^Fp, Hh, Hh, Hh, Gs, Gs^Fms, Gs, Gs^Fms, Gll, Gll^Feth, Ss, Gs^Fms, Gs^Fms, Gll^Fp
Gg, Gll^Fmw, Gll^Fp, Gll^Fmw, Gs^Fms, Gs^Fds, Gs^Fms, Gll^Fp, Gs^Fms, Gs^Fms, Gs^Fds, Gs^Fms, Gll^Fmf, Hh^Fp, Hh, Gs^Fms, Gs^Fms, Hh, Gs^Fms, Gs^Fms, Gs^Fms, Gs^Es, Gll^Fp, Gs, Gs^Fms, Gs, Gll, Gll^Em, Ss, Ss, Gll^Fmf, Gll^Fp
Gs^Fms, Gs^Fms, Ss, Gll^Feth, Gll^Em, Gs^Fms, Gll^Em, Gs, Gs, Gs^Fms, Gs^Fms, Gll, Gll^Fp, Gs^Fms, Gs^Fms, Gs^Fms, Gs^Fms, Gs^Fms, Hh, Gs^Fms, Hh, Gs, Gs^Fms, Gs^Fms, Gs^Fms, Gs, Gll^Fp, Gs^Fms, Gs^Fms, Gs^Fms, Gll^Fmw, Gll^Fmw
Gs^Fms, Gs^Fms, Gll^Fp, Gll^Fms, Hh^Es, Hh, Hh, Hh, Hh, Gs, Gs^Efm, Gs, Gs^Fms, Ss, Ss, Ss, Gs^Fms, Hh^Fp, Gll^Fp, Hh, Gs^Es, Gs, Gll^Fmw, Gs^Fds, Gs, Gs, Gll, Gs^Fds, Gs^Fms, Gs^Fms, Gs^Fms, Gll^Fmw
Gll, Gll^Fmw, Gs^Fms, Gs^Fms, Hh^Fp, Hh^Es, Hh^Fp, Hh, Hh^Fms, Hh, Gs, Gll^Fp, Gll^Fmw, Gs^Fms, Gll^Em, Gll^Fp, Gll, Gll^Em, Gll^Fmw, Gs^Fms, Gs^Fms, Gs^Fms, Gs, Gs^Fms, Gs, Gs, Gs, Gll^Fp, Hh, Hh^Fp, Gs^Fms, Gll^Fmw
Gs, Ss, Gll^Fmw, Gs^Fms, Gs^Fms, Gs^Fms, Gs^Fms, Hh^Fp, Gs^Fms, Hh^Fms, Hh, Gs, Gs^Efm, Gs^Efm, Gs^Fms, Gs^Fms, Gs^Fms, Gll, 2 Gs, Gs^Fms, Gs^Fds, Gs^Fms, Gs, Gs^Efm, Gs^Efm, Gs^Efm, Gd^Es, Hh, Hh^Fp, Gll^Fp, Gll^Fp, Hh^Fp
Gs, Hh^Fp, Hh, Hh^Fp, Hh, Hh, Hh^Fp, Gs^Fms, Gs^Fms, Hh, Hh, Hh, Gs, Gs^Efm, Gs^Fms, Gs^Fds, Gs^Fds, Gs^Fms, Gs, Gll^Fp, Gs, Gs, Gs^Fms, Gs^Efm, Gs, Gd, Hh, Hh, Gd^Es, Gll^Fp, Hh^Fp, Hh^Fp
Hh, Hh, Mm, Hh, Mm, Mm, Hh^Fp, Hh^Fp, Gs^Fms, Hh^Fp, Hh, Gll^Fmf, Gs^Fms, Gll^Fp, Gll^Em, Gs^Fms, Gll, Gll^Fmw, Gs^Fms, Gs, Gs, Gs^Fms, Gs^Fds, Gs^Fms, Gs, Hh, Hh, Hh, Gd^Es, Hh^Fp, Hh, Hh
Hh, Hh^Es, Mm^Xm, Mm, Mm, Hh, Hh, Gll^Fmw, Gll^Em, Gll^Fp, Gs^Fms, Gll^Fmw, Gs^Fms, Gs^Fds, Gll^Fmw, Gs, Gs^Fms, Gs^Fms, Gs^Fms, Gll^Fmw, Gll^Fp, Gll^Fmw, Gll^Feth, Gs^Fms, Gs, Hh, Gs^Efm, Gd, Hh, Hh^Fp, Mm, Hh
Mm^Xm, Mm, Mm^Xm, Mm, Mm, Mm, Hh, Hh^Fp, Gs^Fms, Gll^Fmw, Gs^Fds, Gll, Gs, Gs^Fms, Gs, Gs, Gs^Efm, Gs^Fds, Gll^Fp, Gll, Gll^Em, Gs^Fms, Gs^Fms, Gs, Gs, Gs^Fms, Gd, Gd, Hh, Hh, Mm, Hh
Mm^Xm, Mm^Xm, Mm, Mm, Wwf^Dr, Mm, Hh, Gs^Fms, Gs^Fms, Gs^Fms, Gs^Fms, Gs^Fms, Gll^Fp, Gs, Gs^Fds, 3 Gs^Efm, Gs^Efm, Gs, Gs, Gs, Gs^Efm, Gll^Fp, Gs^Fds, Gll^Fmw, Hh, Gd, Gg^Fp, Hh^Fp, Hh^Fp, Hh^Fp, Mm, Hh
Mm^Xm, Mm^Xm, Mm^Xm, Mm, Mm, Wwf, Hh, Hh^Fp, Gs^Es, Gll^Fmw, Gs^Efm, Gll^Fmw, Gs^Fds, Gs^Fms, Gs^Fms, Gs, Gll^Fmw, Gs^Fms, Gs^Fds, Gs^Fms, Gs, Gs^Fms, Gs^Fms, Hh^Fp, Hh, Hh, Hh, Hh, Hh, Hh^Fp, Mm, Mm
Mm, Mm, Mm, Mm, Mm, Wwf, Wwf, Hh, Gs, Gs, Gs, Gs^Fms, Gs^Fds, Gs^Fds, Gll^Fp, Gs, Gll, Gs^Fms, Gs^Fds, Gs^Fds, Gs^Fms, Gs^Fms, Gll^Fmw, Hh, Gd^Es, Hh, Hh^Fp, Hh, Hh, Mm, Mm, Mm
Mm, Mm, Mm, Mm, Mm, Hh, Hh, Wwf, Ww, Gll^Gvs, Gg^Vc, Gs^Fms, Gs^Fms, Gll^Fmw, Re, Re, Gs^Fds, Gll^Fmw, Gll^Fmw, Gll^Em, Gs, Gs, Gs, Gd, Hh^Fp, Hh, Hh, Hh, Mm, Mm, Mm, Mm
Mm, Mm, Hh, Hh, Hh, Hh^Fp, Gs^Fms, Gg, Wwrg, Gll^Gvs, Gll^Gvs, Gs^Gvs, Gs, Gs, Re, Gs^Fms, Gs^Fms, Gs^Fms, Gs^Fms, Gs^Fms, Gd, Gd, Gd, Gd, Hh, Hh, Hh, Mm, Mm, Mm, Mm, Mm
Hh, Hh^Fp, Gs^Fms, Hh^Fp, Gs^Fms, Gs^Fms, Gs^Fms, Gs^Fms, Gg, Ww, Gg^Gvs, Gg^Gvs, Gs^Fds, Gs^Fms, Re, Gs, Gs, Gs, Gs, Gs, Gd, Hh^Fp, Hh, Gg^Fp, Hh^Fp, Hh^Fp, Mm, Hh, Mm, Mm, Mm^Xm, Mm^Xm
Hh, Gs^Fms, Gs^Fms, Gs^Fms, Gs^Fds, Gs^Fms, Gs^Fms, Gg, Ww, Ww, Gg, Gg, Gg, Gs^Fms, Gg, Re, Gg, Gg, Gs, Gd, Gd, Gd^Es, Hh, Hh, Hh, Hh^Fp, Mm, Mm, Mm, Mm^Xm, Mm^Xm, Mm^Xm
Gs^Fms, Gs^Fms, Gg, Gs^Fds, Gg^Vc, Gs^Fms, Gg, Gg, Wwrg, Gg, Gg, Gg, Gg, Gg, Re, Re, Gg, Gs, Hh, Hh, Gg^Fp, Gg^Fp, Hh^Fp, Hh, Hh^Fp, Mm, Mm, Mm, Mm^Xm, Mm, Mm^Xm, Mm^Xm
Gs^Fms, Gs^Fms, Gg, Gll^Gvs, Gs^Fms, Gll^Gvs, Gg, Wwf, Gg, Gg, Gg, Ce, 1 Ke, Ce, Re, Gg, Gg^Vc, Gs^Gvs, Gs^Gvs, Hh, Hh^Fp, Hh, Hh, Hh, Mm, Mm, Mm, Mm, Mm, Mm^Xm, Mm^Xm, Mm^Xm
Gs^Fms, Hh, Gs^Fds, Gs^Fds, Gll^Gvs, Gs^Gvs, Gg, Wwf, Gg, Gg, Re, Ce, Re, Ce, Re, Gll^Gvs, Gll^Gvs, Gll^Gvs, Gs^Gvs, Hh, Hh, Hh, Hh, Hh, Mm, Mm, Mm, Mm, Mm^Xm, Mm^Xm, Mm^Xm, Mm^Xm
Gs^Fms, Hh, Hh, Gs^Fms, Gg^Es, Gg, Gs^Fds, Ww, Ww, Gs^Fds, Gs^Fds, Re, Gg, Re, Gg, Re, Gg, Gll^Gvs, Hh, Gg^Fp, Hh, Hh, Hh^Vhh, Mm, Mm, Mm, Mm, Mm, Mm^Xm, Mm^Xm, Mm, Mm^Xm
Gs^Fms, Gs^Fds, Gs^Fms, Gg, Hh, Gs^Fds, Gs^Fds, Gs^Fds, Ww, Gs^Fds, Hh, Hh, Hh, Gg, Re, Re, Gg, Gs, Hh, Hh, Hh, Hh, Mm, Mm, Mm, Mm, Mm, Mm, Mm, Mm, Hh, Mm^Xm
Gs^Fms, Gs^Fms, Gs^Fms, Gs^Fms, Hh, Hh, Gll, Ww, Gll^Fp, Gg, Gll^Fp, Hh, Gll^Fp, Re, Re, Gg, Gll, Gs, Hh, Hh, Gg, Mm, Gg, Gg, Gg, Gg, Gg, Mm, Mm, Hh, Mm^Xm, Mm^Xm
