Xom, Xom, Xom, Xom, Xom, Xom, Xom, Xom, Xom, Xom, Rr^Pw|, Xom, Xom, Xom
Xom, Rb, Ior, Iwr^Ebn, Iwr, Iwr, Urc, Iwr^Ebn, Iwr, Iwr, Iwr, Iwr, Iwr^Ebn, Xom
Xom, Ior, Urc, Ior, Urc, Ket, Iwr, Iwr, Iwr, Iwr, Iwr, Iwr, Iwr, Xom
Xom, Iwr, Ket, Ior, Ior, Iwr, Iwr, Iwr, Ket, Urc, Ior, Ior, Rb, Xom
Xom, Iwr, Urc, Ior, Iwr, Urc, Iwr, Urc, Iwr, Iwr, Ior, Ior, Rb, Xom
Xom, Iwr^Ebn, Iwr, Iwr, Urc, Ket, Ior, Ior, 3 Iwr, Iwr, Iwr, Iwr, Iwr^Ebn, Xom
Xom, Xom, Ket, Iwr, Iwr, Iwr, Ior, Ior, Iwr, Iwr, Ket, 2 Urc, Iwr, Xom
Xom, Iwr, Iwr, Ket, Ket, Iwr, Iwr, Ior, Iwr, 1 Urc, Ior, Ior, Iwr, Xom
Xom, Iwr, Iwr, 4 Iwr, Iwr, Xom, Rr^Pw\, Iwr, Rb, Ior, Rb, Rb, Iwr^Ebn, Xom
Xom, Iwr, Iwr, Iwr, Iwr^Ebn, Iwr, Iwr, Xom, Xom, Rb, Rb, Rb, Rb, Xom
Xom, Xom, Xom, Xom, Xom, Xom, Xom, Xom, Xom, Xom, Xom, Xom, Xom, Xom
