Re, Gg, Gg, Gg, Gll^Eff, Gll^Eff, Gll^Gvs, Gs, Gll^Gvs, Gs^Fds, Gs^Fds, Gs^Fds, Gs^Fds, Gg, Re, Gg, Gs^Fds, Gg, Gs^Fds, Hh, Hh, Mm, Mm, Gg, Mm, Gg, Mm, Gg, Mm, Gg, Mm, Gg, Mm, Gg, Mm, Gg, Mm, Gg, Mm, Hh, Hh, Gs^Fds, Gs^Fds, Gg, Gs, Gg, Gg, Gg, Re, Gg, Gg
Gg, Re, Re, Gg^Eff, Gg^Eff, Gll^Gvs, Gs^Eff, Gs^Vhr, Gll^Gvs, Gs^Fds, Gs^Fds, Gs^Fds, Gg, Re, Gs^Fds, Gs^Fds, Gs^Fms, Gs^Fds, Gs^Fds, Gs^Fds, Hh, Mm, Mm, Mm, Mm, Mm, Mm, Mm, Mm, Mm, Mm, Mm, Mm, Mm, Mm, Mm, Mm, Mm, Mm, Hh, Hh^Fms, Gs^Fds, Gs^Fds, Gs^Fds, Gs, Gg^Efm, Gg, Re, Gg, Gg, Gg^Efm
Gg^Efm, Gg, Re, Gg, Gg, Gs^Eff, Re, Gg, Gg, Gs^Fms, Gg, Gs^Fds, Re, Re, Gg, Gs^Fms, Gs^Fms, Gs^Fds, Hh, Hh, Hh, Hh, Mm, Mm, Mm, Mm, Mm, Mm, Mm, Mm, Mm, Mm, Mm, Mm, Mm, Mm, Mm, Mm, Mm, Hh^Fmw, Hh, Hh^Fms, Hh^Fms, Gs^Fds, Gs^Fds, Gg, 3 Re, Re, Gs^Fds, Gg^Efm, Gs^Fds
Gs, Gg^Efm, Gg, Re, Re, Re, Ce, Ce, Ce, Gg, Gs^Fds, Re, Gs^Fds, Gg, Gs^Fds, Gg^Efm, Gg^Efm, Gs^Fds, Gs^Fds, Hh, Mm, Mm, Hh, Mm, Wwrg, Mm, Mm, Mm, Mm, Mm, Mm, Mm, Mm, Mm, Hh, Mm, Hh, Hh^Fms, Hh, Hh, Hh^Fms, Hh, Gs^Fds, Gs^Fds, Gg, Re, Gg, Gg, Gs^Fds, Gs^Fds, Hh^Fmw
Gs, Gs^Eff, Gg^Eff, Gg, Gs, Gg, Ce, 2 Ke, Ce, Gg, Gg, Re, Gs^Fds, Gs^Fds, Gs^Fms, Gg^Efm, Gs^Fds, Gs^Fds, Gs^Fds, Hh, Hh, Hh, Hh, Mm, Wwf, Mm, Mm, Mm, Mm, Mm, Hh, Mm, Mm, Mm, Hh, Hh, Hh^Fms, Gs^Fds, Gs^Fds, Hh, Gs^Fds, Hh^Fms, Gs^Fds, Gs^Fds, Gg, Re, Gg^Efm, Gs^Fds, Gs^Fds, Hh^Fms, Hh^Fms
Gg, Gg^Vhr, Gll^Gvs, Gs^Eff, Gg, Gs, Gll^Gvs, Ce, Gll^Gvs, Re, Re, Re, Gg, Gs^Fms, Gg, Gg, Gg^Efm, Gs^Fms, Gg^Efm, Hh, Gs^Fds, Gs^Fds, Wwf, Wwf, Hh, Hh, Mm, Mm, Hh^Fmw, Hh, Mm, Hh, Hh, Hh^Fms, Hh^Fms, Hh^Fmw, Gs^Fds, Gs^Fds, Gs^Fds, Gs^Fds, Gll^Gvs, Gs^Fds, Gll, Gg, Re, Re, Gs^Fds, Gs^Fds, Hh^Fms, Hh^Fmw, Hh^Fmw
Gg, Gll^Gvs, Gll^Gvs, Gll^Gvs, Gg^Eff, Gg, Gs^Vhr, Gll^Gvs, Gll^Gvs, Gll^Gvs, Re, Re, Re^Vc, Gg, Gg, Gg^Efm, Gg^Efm, Gg^Efm, Gs^Fds, Gs^Fds, Gs^Fds, Gs^Fds, Wwf, Hh, Gs^Fds, Hh, Hh, Hh^Fms, Gs^Fds, Hh, Hh, Hh^Fmw, Hh^Fms, Gs^Fds, Gs^Fds, Hh^Fms, Gs^Fds, Gs^Fds, Gs^Fds, Gll^Gvs, Gll^Gvs, Gll^Vhr, Hh, Gs, Re, Gg^Efm, Gs^Efm, Hh^Fms, Hh, Hh, Hh
Gs, Gll^Gvs, Gll^Gvs, Gg, Gg, Gg^Eff, Gg^Eff, Gll^Gvs, Gg^Eff, Gg^Eff, Chr, Re, Re, Gg, Gs, Gg, Gs, Gs^Fds, Gs^Fds, Gs^Fds, Gs^Fds, Gs^Fds, Wwg, Gs^Fds, Gs^Fds, Hh, Gg, Gs^Fds, Gs^Fds, Hh^Fms, Hh, Gs^Fds, Gs^Fds, Gs^Fds, Gs^Fds, Gs^Fds, Hh^Fmw, Gs^Fds, Hh, Gll^Gvs, Hh, Hh, Gs^Efm, Chr, Re, Gg^Efm, Hh, Hh, Hh, Hh^Fmw, Hh^Fmw
Gs, Gs, Gs, Gg, Gs^Fds, Gs^Fds, Gg, Gg, Gg^Efm, Gg^Efm, Gg^Efm, Re, Re, Gg, Gs, Gs, Gs, Gg, Gg, Gg^Efm, Gg^Efm, Gs^Fds, Gg, Wwg, Wwg, Gg, Gg, Gs^Fds, Gll^Gvs, Gg^Vc, Gll^Gvs, Gs^Fds, Gs^Fds, Gs^Fds, Hh^Fmw, Hh, Hh^Fms, Hh^Fmw, Hh, Hh, Hh, Hh, Gg, Re, Gg, Chr, Hh, Hh, Hh^Fmw, Hh^Fmw, Hh
Gs^Fms, Gs, Gs^Fms, Gs, Gs^Fms, Gs^Fds, Gs^Fms, Gs, Gs, Gg^Efm, Gs, Gg^Efm, Gg^Efm, Re, Re, Gg, Gg^Vhr, Gg, Re, Gg^Efm, Gg, Gg^Efm, Gg, Gg, Wwg, Gg, Gg, Gg, Gg, Gll^Gvs, Gg, Gs^Fds, Gs^Efm, Gs^Fds, Hh, Hh, Hh, Hh, Gs^Efm, Gs^Efm, Gg^Efm, Gg, Re, Re, Gg^Efm, Hh, Gs^Fds, Hh^Fms, Hh^Fms, Hh, Hh
Gs^Fms, Gs^Fms, Hh^Fmw, Gs^Fms, Gs^Fms, Hh, Hh^Fmw, Hh, Gs^Fms, Gs, Gs, Gs, Gs, Gg, Gg, Re, Re, Re, Gg^Efm, Re, Re, Gg, Gll, Gg, Gll, Wwg, Wwg, Gg, Gll, Gg, Gg, Gg^Efm, Gg^Efm, Hh, Gg, Gs^Efm, Gg, Hh, Gg^Efm, Gg^Efm, Re, Re, Gg, Gg, Gs^Fds, Hh, Gs^Fds, Gs^Fds, Gs^Fds, Hh, Hh
Hh, Hh, Hh, Hh, Hh, Hh, Mm, Hh, Hh^Fmw, Gs^Fms, Gs^Fms, Gs^Fms, Gs, Gs^Fds, Gs, Gg, Re, Gg, Gg, Gg, Re, Gg, Gll, Gll, Sm^Edt, Gll, Wwg, Gll, Sm, Gll, Gll, Gg, Re, Gg, Re, Re, Re, Re, Re, Re, Gs, Gg, Gs^Fds, Gs^Fds, Gs^Fds, Gs^Fds, Gs^Fds, Gs^Fds, Hh^Fms, Hh^Fmw, Hh
Hh^Fmw, Hh, Mm, Mm, Mm, Mm, Mm, Hh, Hh, Gs^Fms, Hh^Fmw, Gs^Fms, Hh, Gs^Fms, Gs^Fms, Gs^Fms, Gs^Fds, Re, Gg, Gll, Gll, Re, Sm^Bp\, Sm, Kh, Wwg, Rb^Edt, Wwg, Chr^Es, Sm, Rb, Re, Gs^Vhr, Re, Gs^Fds, Gs^Fds, Hh^Fms, Gs^Fds, Hh, Hh, Gll^Gvs, Gll^Gvs, Gg^Vc, Gs^Fds, Gs^Fms, Gs^Fms, Gs^Fds, Gs^Fds, Hh^Fms, Hh^Fmw, Hh
Hh, Hh, Mm, Mm, Mm, Mm, Mm, Mm, Hh, Hh, Hh, Hh, Mm, Hh^Fmw, Hh^Fmw, Gs^Fms, Gs, Re, Gg, Gll, Sm, Wwg, Rb^Edt, Rb^Edt, Ch^Edt, Rb, Ch, Rb, Rb^Edt, Sm^Bp/, Sm, Gll, Gll, Gs, Gg^Efm, Gs^Fds, Hh, Hh^Fmw, Hh, Hh, Gs, Gll^Gvs, Gll^Gvs, Hh^Fms, Hh, Hh^Fms, Hh^Fmw, Hh^Fms, Hh^Fms, Mm, Mm
Mm, Mm, Mm, Mm, Mm, Mm, Mm, Mm, Mm, Hh, Mm, Mm, Hh, Hh, Hh^Fmw, Gs^Fms, Gs, Re, Gll, Gll, Sm^Edt, Chr^Es, Rb^Vhr, Rb^Edt, Chr, 1 Kf, Ch^Edt, Rb, Rb^Vhr, Cer, Sm, Gll, Gg, Gg, Gg^Efm, Gg^Efm, Gg, Gg^Efm, Gg, Gs, Gs^Fds, Gs^Fds, Hh^Fms, Hh, Mm, Hh, Mm, Hh, Mm, Mm, Mm
Hh, Mm, Mm, Mm, Mm, Mm, Mm, Mm, Mm, Mm, Mm, Mm, Hh, Hh^Fmw, Hh^Fmw, Gs^Fms, Gs^Fds, Re, Gg, Gll, Wwg, Cer, Rb^Es, Rb, Chr, Ch, Ch, Rb, Rb, Cer^Es, Sm, Gll, Wwg, Gg, Wwf, Wwf, Wwf, Gg, Hh, Hh, Hh^Fms, Gs^Fds, Hh^Fmw, Hh^Fmw, Mm, Mm, Mm, Mm, Mm, Mm, Mm
Mm, Rd, Rd, Mm, Rd, Mm, Rd, Hh, Hh, Mm, Mm, Mm, Mm, Mm, Hh, Hh^Fmw, Gs^Fms, Re, Re, Gll, Wwg, Cer, Cer, Rb, Rb, Ch, Rb^Es, Rb, Rb^Vhr, Sm^Edt, Wwg, Wwg, Gg, Wwg, Gg, Gg, Gg, Wwf, Hh, Hh^Fms, Mm, Hh^Fms, Mm, Mm, Mm, Mm, Mm, Mm, Mm, Mm, Mm
Mm, Mm, Hh, Rd, Hh, Rd, Hh, Rd, Rd, Hh, Mm, Mm, Mm, Mm, Mm, Hh^Fmw, Gs^Fms, Gs^Fms, Re, Gll, Gll, Sm, Sm^Edt, Sm^Edt, Ch, Rb, Chr, Rb^Edt, Sm^Edt, Cer, Wwg, Gll, Gd^Fds, Gg, Hh, Gg, Hh, Wwf, Wwrg, Mm, Mm, Mm, Mm, Mm, Mm, Mm, Mm, Mm, Mm, Mm, Mm
Mm, Mm, Mm, Hh, Mm, Hh, Mm, Mm, Mm, Rd, Rd, Rd, Rd, Gg, Gg, Hh, Hh, Gs^Fms, Re, Gll, Gg, Gll, Gll, Wwg, Sm, Sm^Bp|, Sm, Sm, Gll, Wwg, Gll, Gll, Gd^Fds, Gd^Fds, Hh, Hh, Hh, Hh, Mm, Mm, Mm, Mm, Mm, Mm, Mm, Mm, Mm, Mm, Hh, Mm, Hh
Mm, Mm, Mm, Mm, Mm, Mm, Mm, Mm, Mm, Mm, Hh, Hh, Hh, Gg, Gs^Fds, Gg, Gg, Gg, Gg, Re, Re, Gll, Gg, Gll, Gg, Re, Gll, Gll, Gg, Gll, Gg, Gd^Fds, Gd^Fds, Gd^Fds, Hh, Mm, Mm, Mm, Mm, Mm, Hh, Mm, Hh, Mm, Hh, Hh, Hh, Hh, Hh, Hh, Hh
Hh, Hh, Hh, Mm, Mm, Mm, Mm, Mm, Mm, Mm, Mm, Hh, Hh, Hh, Gs^Fms, Gs^Fms, Gs^Fms, Gg, Gg^Efm, Gg, Gg, Re, Gg, Gg, Re, Re, Gg, Gg, Gd^Fds, Gd^Fds, Hh, Hh, Hh, Hh, Hh, Hh, Hh, Mm, Hh, Hh, Wwg, Hh, Hh^Fds, Hh, Gd^Fds, Hh, Gd^Fds, Gd^Fds, Hh, Hh, Hh
Hh, Hh, Hh, Hh, Hh, Hh, Hh, Mm, Mm, Mm, Mm, Hh, Mm, Hh, Hh, Gs^Fms, Gs^Fds, Gg^Efm, Gg^Efm, Gg^Efm, Gg, Re, Gg, Re, Gg^Efm, Gg^Efm, Gg^Efm, Gd^Fds, Gd^Fds, Hh, Mm, Mm, Hh, Gd^Fds, Gd^Fds, Hh^Fds, Hh, Hh, Hh^Fds, Hh, Wwg, Hh, Hh, Gd^Fds, Gd^Fds, Hh^Fds, Gd^Fds, Gd^Fds, Gd^Fds, Hh^Fds, Hh
Gs^Fds, Hh, Hh, Hh, Hh, Hh, Gs^Fds, Hh, Hh, Hh, Hh, Mm, Hh, Hh, Hh, Gs^Fms, Gs^Fms, Gs^Fms, Gg^Efm, Gg^Efm, Gg^Efm, Re, Re, Re, Gg^Efm, Gg^Efm, Gg^Efm, Gd^Fds, Hh, Hh, Mm, Mm, Hh^Fds, Hh, Gd^Fds, Gd^Fds, Gd^Fds, Gd^Fds, Gd^Fds, Gd^Fds, Wwg, Gd^Fds, Gg, Gd^Fds, Gd^Fds, Gd^Fds, Gd^Fds, Gd^Fds, Gd^Fds, Gd^Fds, Gd^Fds
Gs^Fds, Gs^Fds, Gs^Fds, Gs^Fds, Hh, Gs^Fds, Gs^Fds, Hh, Gs^Fds, Gs^Fds, Gg, Hh, Gs^Fds, Gs^Fds, Gs^Fds, Gs^Fds, Gs^Fds, Gs^Fds, Gg^Efm, Gg^Efm, Gg, Re, Gg, Gg^Efm, Gg^Efm, Gg^Efm, Gs^Efm, Gg, Gd^Fds, Hh^Fds, Hh, Hh, Hh, Gd^Fds, Gs, Gg, Gg, Gd^Fds, Wwg, Wwg, Gd^Fds, Gs, Gg, Gd^Fds, Gs, Gg, Gs, Gg, Gg, Gg, Gg
Gs^Fds, Gs^Fds, Gs^Fds, Gs^Fds, Gs^Fds, Gs^Fds, Gs^Fds, Gs^Fds, Gg, Gs^Fds, Gg, Gg, Gs^Fds, Gs^Fds, Gg, Gs^Fds, Gg, Gs^Fds, Gg, Gg, Gs, Re, Re, Gg, Gg, Gg^Efm, Gg, Gd^Fds, Gd^Fds, Hh, Gs, Hh, Gs, Gg^Gvs, Gs^Gvs, Gd^Fds, Gs, Gg, Wwg, Gg, Gs, Gs, Gd^Fds, Gg, Gs^Efm, Gd^Fds, Gd^Fds, Gg, Gd^Fds, Gg, Gd^Fds
Hh, Gs^Fds, Hh, Gs^Fds, Gs, Gs^Fds, Gs^Fds, Gs^Fds, Gg, Gg, Gg^Gvs, Gg^Gvs, Gs^Vc, Gg^Gvs, Gg^Gvs, Gg, Gg^Efm, Gg, Gs, Gs, Gs, Gs, Gs, Re, Re, Gg, Re, Gg, Gg, Gs, Gg, Gs, Gg, Gg^Vc, Gg, Gg, Wwg, Wwg, Gg, Gg, Gg, Gs, Gg, Gg^Efm, Gg^Efm, Gs, Gg, Gs, Gg^Gvs, Gs, Gg
Hh, Hh, Hh, Hh, Gs, Gs, Gs^Es, Gg, Gg, Gg^Efm, Gs, Gs^Gvs, Gs, Gs^Gvs, Gd, Gs, Gs, Gs, Hh, Hh, Hh, Hh, Hh, Gs, Gs, Re, Gg, Re, Re, Gg, Re, Re, Re, Re, Re, Re, Wwg^Bw\, Gg, Re, Re, Re, Re, Re, Gg, Re, Gg, Gg^Efm, Gg^Efm, Gg^Vc, Gg^Gvs, Gg
Hh, Hh, Hh^Fds, Hh^Fds, Hh, Hh, Hh, Gs, Gs, Gs, Gs, Gd, Gd, Gd, Gs, Gs, Gs^Es, Hh, Hh, Hh^Fds, Hh^Fds, Hh^Fds, Hh, Hh, Gs^Gvs, Gg^Gvs, Gs^Gvs, Gg, Gg, Re, Gg, Gg, Gg, Gg, Wwg, Wwg, Gg, Re, Gg, Gg, Gs, Gg, Gg, Re, Gg, 4 Re, Re, Gg, Gg, Gg^Gvs, Gg
Hh, Hh, Hh, Hh^Fds, Hh, Hh^Fds, Hh, Hh, Hh^Fds, Hh, Gs, Gd^Efm, Gd^Wm, Gd^Efm, Gs, Hh, Hh, Hh, Gs, Hh, Hh, Hh, Hh, Hh^Fds, Hh, Gs^Vc, Gs, Gg, Gg, Gg, Wwg, Wwg, Wwg, Wwg, Gg, Gg, Gg, Gg, Gg^Efm, Gs, Hh, Gs, Gs, Gg, Gg, Gg, Gg, Re, Re, Gg, Re
Hh, Hh, Hh, Hh, Hh, Hh, Hh, Hh, Hh, Hh, Gs, Gd^Efm, Gd^Efm, Gd^Efm, Gs, Hh, Gs, Gs, Gs, Gs, Gs^Efm, Hh, Gs, Hh, Gs, Gs, Gg, Gg, Wwg, Wwg, Gg, Gg, Gg, Gg, Gs, Gs, Gs^Es, Gs^Efm, Gs^Efm, Gs^Efm, Hh, Hh, Gs, Gd^Efm, Gd^Efm, Gd^Efm, Gd^Efm, Gg, Gs, Re, Gg
Gs, Hh, Gs, Hh, Gs, Hh, Hh, Gs, Gs, Gs, Gd, Gd, Gd, Gd, Gs, Gs, Gs, Gs, Gs, Gs^Efm, Gs^Efm, Gs^Efm, Gs^Fds, Gs, Gs^Fds, Gg, Gg, Gg, Wwg, Gg, Gg, Gg, Gg, Gg^Efm, Gs^Efm, Hh, Hh, Hh, Hh, Hh, Hh, Hh, Hh, Gs^Efm, Gs^Efm, Gd^Efm, Gs^Efm, Gs, Gs, Gs, Gs
Gg, Gs, Gd, Gs^Es, Gs, Gs^Vc, Gs, Gs, Gs, Gs, Gg, Gg, Gg, Gg, Gg, Gg, Gs, Hh, Hh, Hh, Gs, Gs^Fds, Gs^Fds, Gs^Fds, Wwg, Wwg, Wwg, Wwg, Gs^Fds, Gg, Gd, Gg^Efm, Gs^Efm, Gs^Efm, Gs, Hh, Hh, Hh, Hh^Fds, Hh^Fds, Hh, Hh, Hh, Hh, Gs^Es, Gs, Hh, Gs^Efm, Hh, Hh, Hh
Gg, Gg, Gd, Gd, Gd, Gd, Gd, Gs, Gg, Gg, Gg, Gg, Gg, Gg, Gg, Gs, Hh, Hh^Fds, Hh^Fds, Hh, Hh, Gs^Fds, Gs^Fds, Wwg, Gs^Fds, Gs^Fds, Gs^Fds, Gs^Fds, Gs^Fds, Gd, Gs^Efm, Gd^Efm, Hh, Hh, Hh, Hh, Hh, Hh^Fds, Hh^Fds, Hh^Fds, Hh^Fds, Hh^Fds, Hh^Fds, Hh, Gs^Fds, Gs, Gs, Hh, Hh^Fds, Hh^Fds, Hh
Gg, Gg, Gg, Gg, Gg, Gg, Gg, Gg, Gg, Gg, Gg, Gg, Gg, Gg, Gg, Gs, Gg, Hh, Gg, Hh, Hh, Gs^Fds, Wwg, Wwg, Gg, Gs^Fds, Gg, Gs^Fds, Gs^Fds, Gs^Fds, Gs, Gs, Hh, Hh, Hh, Hh, Hh, Hh, Hh, Hh, Hh^Fds, Gg^Fds, Gg^Fds, Gg^Fds, Hh^Fds, Hh, Hh, Hh, Hh, Hh^Fds, Hh^Fds
