Xuc, Xuc, Xuc, Xuc, Xuc, Xuc, Xuc, Xuc, Xuc, Xuc, Xuc, Xuc, Xuc, Xuc, Xuc, Xuc, Xuc, Xuc, Xuc, Xuc, Xuc, Xuc, Xuc, Xuc, Xuc, Xuc, Xuc, Xuc, Xuc, Xuc, Xuc, Xuc, Xuc, Xuc, Xuc, Xuc, Xuc, Xuc, Xuc, Xuc, Xuc, Xuc, Xuc, Xue, Uue, Xue, Xuc, Xuc, Xuc, Xuc, Xue, Xue, Xue, Xue, Xue, Xue
Xuc, Xuc, Xuc, Xuc, Xuc, Xuc, Xuc, Xuc, Xuc, Xuc, Xuc, Xuc, Xuc, Xuc, Xuc, Xuc, Xuc, Xuc, Xuc, Xuc, Xuc, Xuc, Xuc, Xuc, Xuc, Xuc, Xuc, Xuc, Xuc, Xuc, Xuc, Xuc, Xuc, Xuc, Xuc, Xuc, Xuc, Xuc, Xuc, Xuc, Xuc, Xuc, Xuc, Xue, Uue, Xue, Xue, Xuc, Xuc, Xuc, Xue, Xue, Xue, Xue, Xue, Xue
Xuc, Xuc, Xuc, Xuc, Xuc, Xuc, Xuc, Xuc, Xuc, Xuc, Xuc, Xuc, Xuc, Xuc, Xuc, Xuc, Xuc, Xuc, Xuc, Xuc, Xuc, Xuc, Xuc, Xuc, Xuc, Xuc, Xuc, Xuc, Xuc, Xuc, Xuc, Xuc, Xuc, Xuc, Xuc, Xuc, Xuc, Xuc, Xuc, Xuc, Xuc, Xuc, Xuc, Xue, Uue, Uue, Xue, Xue, Xuc, Xuc, Xue, Xue, Xue, Xue, Xue, Xue
Xuc, Xuc, Xuc, Xuc, Xuc, Xuc, Xuc, Xuc, Xuc, Xuc, Xuc, Xuc, Xuc, Xuc, Xuc, Xuc, Xuc, Xuc, Xuc, Xuc, Xuc, Xuc, Xuc, Xuc, Xuc, Xuc, Xuc, Xuc, Xuc, Xuc, Xuc, Xuc, Xuc, Xuc, Xuc, Xuc, Xuc, Xuc, Xue, Xue, Xue, Xue, Xue, Xue, Xue, Uue, Uue, Xue, Xuc, Xuc, Xue, Xue, Xue, Xue, Xue, Xue
Xuc, Xuc, Xuc, Xuc, Xuc, Xuc, Xuc, Xuc, Xuc, Xuc, Xuc, Xuc, Xuc, Xuc, Xuc, Xuc, Xuc, Xuc, Xuc, Xuc, Xuc, Xuc, Xuc, Xuc, Xuc, Xuc, Xuc, Xuc, Xuc, Xuc, Xuc, Xuc, Xuc, Xuc, Xuc, Xuc, Xuc, Xuc, Xue, Uue, Uue, Uue, Uue, Xue, Uue, Uue, Uue, Xue, Xue, Xuc, Xue, Xue, Uue, Uue, Uue, Uue
Xuc, Xuc, Xuc, Xuc, Xuc, Xuc, Xuc, Xuc, Xuc, Xuc, Xuc, Xuc, Xuc, Xuc, Xuc, Xuc, Xuc, Xuc, Xuc, Xuc, Xuc, Xuc, Xuc, Xuc, Xuc, Xuc, Xuc, Xuc, Xuc, Xuc, Xuc, Xuc, Xuc, Xuc, Xuc, Xuc, Xuc, Xuc, Xue, Uue, Uue, Uue, Uue, Uue, Cte, Cte, Cte, Uue, Uue, Xue, Xue, Xue, Uue, Uue, Xue, Uue
Xuc, Xuc, Xuc, Xuc, Xuc, Xuc, Xuc, Xuc, Xuc, Xuc, Xuc, Xuc, Xuc, Xuc, Xuc, Xuc, Xuc, Xuc, Xuc, Xuc, Xuc, Xuc, Xuc, Xuc, Xuc, Xuc, Xuc, Xuc, Xuc, Xuc, Xuc, Uue, Uue, Xuc, Xuc, Xuc, Xuc, Xue, Uue, Uue, Uue, Uue, Uue, Uue, Cte, 2 Ke, Cte, Uue, Uue, Xue, Uue, Uue, Uue, Xue, Xue, Xue
Xuc, Xuc, Xuc, Xuc, Xuc, Xuc, Xuc, Xuc, Xuc, Xuc, Xuc, Xuc, Xuc, Xuc, Xuc, Xuc, Xuc, Xuc, Xuc, Xuc, Xuc, Xuc, Xuc, Xuc, Xuc, Xuc, Xuc, Xuc, Xuc, Xuc, Xuc, Xuc, Xuc, Uue, Uue, Uu^Vu, Xuc, Xue, Xue, Xue, Uue, Uue, Uue, Uue, Uue, Cte, Uue, Uue, Uue, Uue, Uue, Uue, Xue, Xue, Xue, Xue
Xuc, Xuc, Xuc, Xuc, Xuc, Xuc, Xuc, Xuc, Xuc, Xuc, Xuc, Xuc, Xuc, Xuc, Xuc, Xuc, Xuc, Xuc, Xuc, Xuc, Xuc, Xuc, Xuc, Xuc, Xuc, Xuc, Xuc, Xuc, Xuc, Xuc, Xuc, Xuc, Uue, Uue, Uue, Uue, Xuc, Xuc, Xuc, Xue, Xuc, Uue, Re, Uue, Uue, Uue, Uue, Uue, Uue, Uue, Xue, Xue, Xue, Xue, Xue, Xue
Xuc, Xuc, Xuc, Xuc, Xuc, Xuc, Xuc, Xuc, Xuc, Xuc, Xuc, Xuc, Xuc, Xuc, Xuc, Xuc, Xuc, Xuc, Xuc, Xuc, Xuc, Xuc, Xuc, Xuc, Xuc, Xuc, Xuc, Xuc, Xuc, Xuc, Xuc, Xuc, Xuc, Uu^Vu, Xuc, Uue, Cte, Xuc, Qxe, Xuc, Uue, Re, Uue, Uue, Uue, Uue, Uue, Uue, Uue, Uue, Xue, Xue, Xue, Xue, Xue, Xue
Xuc, Xuc, Xuc, Xuc, Xuc, Xuc, Xuc, Xuc, Xuc, Xuc, Xuc, Xuc, Xuc, Xuc, Xuc, Xuc, Xuc, Xuc, Xuc, Xuc, Xuc, Xuc, Xuc, Xuc, Xuc, Xuc, Xuc, Xuc, Xuc, Xuc, Xuc, Xuc, Xuc, Xuc, Qxu^Bp/, Qxu^Bp/, Qxe, Qxu^Bp\, Re, Re, Uue, Re, Xuc, Xuc, Xue, Uue, Xue, Uue, Xue, Xuc, Xue, Xue, Xue, Xue, Xue, Xue
Xuc, Xuc, Xuc, Xuc, Xuc, Xuc, Xuc, Xuc, Xuc, Xuc, Xuc, Xuc, Xuc, Xuc, Xuc, Xuc, Xuc, Xuc, Xuc, Xuc, Xuc, Uue, Uue, Xuc, Xuc, Xuc, Xuc, Xuc, Xuc, Xuc, Xuc, Xuc, Qxu^Bp/, Qxu^Bp/, Qxe, Qxe, Cer, Uue, Re, Re, Qxu^Bp\, Qxe, Xuc, Xuc, Xuc, Xue, Xue, Xue, Xuc, Xuc, Xue, Xue, Xue, Xue, Xue, Xue
Xuc, Xuc, Xuc, Xuc, Xuc, Xuc, Xuc, Xuc, Xuc, Xuc, Xuc, Xuc, Xuc, Xuc, Xuc, Xuc, Xuc, Xuc, Xuc, Xuc, Xuc, Xuc, Xuc, Uue, Uue, Uue, Xuc, Xuc, Xuc, Xuc, Qxu^Bp/, Qxu^Bp/, Qxe, Qxe, Uue, Re, Re, Cer, Qxe, Qxe, Qxu^Bp/, Cte, Uue, Xuc, Xuc, Xuc, Xuc, Xuc, Xuc, Xuc, Xue, Xue, Xue, Xue, Xue, Xue
Xuc, Xuc, Xuc, Xuc, Xuc, Xuc, Xuc, Xuc, Xuc, Xuc, Xuc, Xuc, Xuc, Xuc, Xuc, Xuc, Xuc, Xuc, Xuc, Xuc, Xuc, Xuc, Uu^Vu, Uue, Uue, Uu^Vu, Xuc, Xuc, Qxu^Bp/, Qxu^Bp/, Qxe, Qxe, Re, Uue, Uue, Re, Qxe, Qxe, Qxu^Bp/, Qxu^Bp/, Xuc, Xuc, Uue, Uu^Vu, Uue, Xuc, Xuc, Xuc, Xuc, Xuc, Xue, Xue, Xue, Xue, Xue, Xue
Xuc, Xuc, Xuc, Xuc, Xuc, Xuc, Xuc, Xuc, Xuc, Xuc, Xuc, Xuc, Xuc, Xuc, Xuc, Xuc, Xuc, Xuc, Xuc, Xuc, Xuc, Uue, Uue, Uue, Xuc, Uue, Cte, Xuc, Qxe, Qxe, Re, Re, Uue, Re, Qxe, Qxe, Qxu^Bp/, Qxu^Bp/, Xuc, Xuc, Uue, Uue, Uu^Vu, Uue, Uue, Xuc, Xuc, Xuc, Xuc, Xuc, Xue, Xue, Xue, Xue, Xue, Xue
Xuc, Xuc, Xuc, Xuc, Xuc, Xuc, Xuc, Xuc, Xuc, Xuc, Xuc, Xuc, Xuc, Xuc, Xuc, Xuc, Xuc, Xuc, Xuc, Xuc, Xuc, Xuc, Xuc, Xuc, Qxu^Bp/, Qxu^Bp/, Qxe, Qxu^Bp\, Uue, Uue, Re, Uue, Qxe, Qxe, Qxu^Bp/, Qxu^Bp/, Xuc, Xuc, Xuc, Xuc, Uue, Uue, Xuc, Xuc, Xuc, Uue, Uue, Xuc, Xuc, Xuc, Xue, Xue, Xue, Xue, Xue, Xue
Xuc, Xuc, Xuc, Xuc, Xuc, Xuc, Xuc, Xuc, Xuc, Xuc, Xuc, Uue, Uue, Xuc, Xuc, Xuc, Xuc, Xuc, Xuc, Xuc, Xuc, Xuc, Qxu^Bp/, Qxu^Bp/, Qxe, Qxe, Cer, Uue, Re, Re, Qxu^Bp\, Qxe, Xuc, Qxu^Bp/, Xuc, Xuc, Xuc, Xuc, Xuc, Xuc, Xuc, Xuc, Xuc, Xuc, Xuc, Xuc, Xuc, Xuc, Xuc, Xuc, Xue, Xue, Xue, Xue, Xue, Xue
Xuc, Xuc, Xuc, Xuc, Xuc, Xuc, Xuc, Xuc, Xuc, Xuc, Xuc, Xuc, Xuc, Uue, Uue, Uu^Vu, Xuc, Xuc, Xuc, Xuc, Qxu^Bp/, Qxu^Bp/, Qxe, Qxe, Re, Uue, Uue, Cer, Qxe, Qxe, Qxu^Bp/, Cte, Uue, Xuc, Xuc, Xuc, Xuc, Xuc, Xuc, Xuc, Xuc, Xuc, Xuc, Xuc, Xuc, Xuc, Xuc, Xuc, Xuc, Xuc, Xue, Xue, Xue, Xue, Xue, Xue
Xuc, Xuc, Xuc, Xuc, Xuc, Xuc, Xuc, Xuc, Xuc, Xuc, Xuc, Xuc, Uue, Uue, Uue, Uue, Xuc, Xuc, Qxu^Bp/, Qxu^Bp/, Qxe, Qxe, Re, Re, Uue, Re, Qxe, Qxe, Qxu^Bp/, Qxu^Bp/, Xuc, Xuc, Uue, Uue, Uu^Vu, Xuc, Xuc, Xuc, Xuc, Xuc, Xuc, Xuc, Xuc, Xuc, Xuc, Xuc, Xuc, Xuc, Xuc, Xuc, Xue, Xue, Xue, Xue, Xue, Xue
Xuc, Xuc, Xuc, Xuc, Xuc, Xuc, Xuc, Xuc, Xuc, Xuc, Xuc, Uue, Uue, Uu^Vu, Xuc, Uue, Cte, Xuc, Qxe, Qxe, Uue, Uue, Re, Uue, Qxe, Qxe, Qxu^Bp/, Qxu^Bp/, Xuc, Xuc, Uue, Uue, Uue, Uue, Uue, Xuc, Xuc, Xuc, Xuc, Xuc, Xuc, Xuc, Xuc, Xuc, Xuc, Xuc, Xuc, Xuc, Xuc, Xuc, Xue, Xue, Xue, Xue, Xue, Xue
Xuc, Xuc, Xuc, Xuc, Xuc, Xuc, Xuc, Xuc, Xuc, Xuc, Xuc, Xuc, Xuc, Xuc, Qxu^Bp/, Qxu^Bp/, Qxe, Qxu^Bp\, Re, Uue, Uue, Uue, Qxe, Qxe, Qxu^Bp/, Qxu^Bp/, Xuc, Xuc, Xuc, Xuc, Uue, Uu^Vu, Xuc, Xuc, Xuc, Uue, Uue, Xuc, Xuc, Xuc, Xuc, Xuc, Xuc, Xuc, Xuc, Xuc, Xuc, Xuc, Xuc, Xuc, Xue, Xue, Xue, Xue, Xue, Xue
Xuc, Xuc, Xuc, Xuc, Xuc, Xuc, Xuc, Xuc, Xuc, Xuc, Xuc, Xuc, Qxu^Bp/, Qxu^Bp/, Qxe, Qxe, Cer, Uue, Re, Re, Qxu^Bp\, Qxe, Xuc, Qxu^Bp/, Xuc, Xuc, Xuc, Xuc, Xuc, Xuc, Xuc, Xuc, Xuc, Xuc, Xuc, Xuc, Xuc, Xuc, Xuc, Xuc, Xuc, Xuc, Xuc, Xuc, Xuc, Xuc, Xuc, Xuc, Xuc, Xuc, Xue, Xue, Xue, Xue, Xue, Xue
Xuc, Xuc, Xuc, Xuc, Xuc, Xuc, Xuc, Xuc, Xuc, Xuc, Qxu^Bp/, Qxu^Bp/, Qxe, Qxe, Re, Uue, Re, Cer, Qxe, Qxe, Qxu^Bp/, Cte, Uue, Xuc, Xuc, Xuc, Xuc, Xuc, Xuc, Xuc, Xuc, Xuc, Xuc, Xuc, Xuc, Xuc, Xuc, Xuc, Xuc, Xuc, Xuc, Xuc, Xuc, Xuc, Xuc, Xuc, Xuc, Xuc, Xuc, Xuc, Xue, Xue, Xue, Xue, Xue, Xue
Xuc, Xuc, Xuc, Xuc, Xuc, Xuc, Xuc, Xuc, Qxu^Bp/, Qxu^Bp/, Qxe, Qxe, Uue, Re, Uue, Re, Qxe, Qxe, Qxu^Bp/, Qxu^Bp/, Xuc, Xuc, Uue, Uu^Vu, Uue, Xuc, Xuc, Xuc, Xuc, Xuc, Xuc, Xuc, Xuc, Xuc, Xuc, Xuc, Xuc, Xuc, Xuc, Xuc, Xuc, Xuc, Xuc, Xuc, Xuc, Xuc, Xuc, Xuc, Xuc, Xuc, Xue, Xue, Xue, Xue, Xue, Xue
Xuc, Xuc, Xue, Xuc, Xue, Xuc, Qxu^Bp/, Qxu^Bp/, Qxe, Qxe, Uue, Re, Uue, Uue, Qxe, Qxe, Qxu^Bp/, Qxu^Bp/, Xuc, Xuc, Uue, Uue, Uue, Uue, Uue, Xuc, Xuc, Xuc, Xuc, Xuc, Xuc, Xuc, Xuc, Xuc, Xuc, Xuc, Xuc, Xuc, Xuc, Xuc, Xuc, Xuc, Xuc, Xuc, Xuc, Xuc, Xuc, Xuc, Xuc, Xuc, Xue, Xue, Xue, Xue, Xue, Xue
Xue, Xue, Xue, Xue, Xue, Xuc, Xuc, Qxe, Uue, Uue, Re, Re, Qxe, Qxe, Qxu^Bp/, Qxu^Bp/, Xuc, Xuc, Xuc, Xuc, Uue, Uu^Vu, Xuc, Xuc, Xuc, Uue, Uue, Xuc, Xuc, Xuc, Xuc, Xuc, Xuc, Xuc, Xuc, Xuc, Xuc, Xuc, Xuc, Xuc, Xuc, Xuc, Xuc, Xuc, Xuc, Xuc, Xuc, Xuc, Xuc, Xuc, Xue, Xue, Xue, Xue, Xue, Xue
Xue, Xue, Xue, Uue, Uue, Uue, Uue, Cte, Cte, Re, Qxe, Qxe, Qxu^Bp/, Qxu^Bp/, Xuc, Xuc, Xuc, Xuc, Xuc, Xuc, Xuc, Xuc, Xuc, Xuc, Xuc, Xuc, Xuc, Xuc, Xuc, Xuc, Xuc, Xuc, Xuc, Xuc, Xuc, Xuc, Xuc, Xuc, Xuc, Xuc, Xuc, Xuc, Xuc, Xuc, Xuc, Xuc, Xuc, Xuc, Xuc, Xuc, Xue, Xue, Xue, Xue, Xue, Xue
Xue, Uue, Uue, Uue, Ce, Uue, Uue, Uue, Uue, Xuc, Xuc, Qxu^Bp/, Xuc, Xuc, Xuc, Xuc, Xuc, Xuc, Xuc, Xuc, Xuc, Xuc, Xuc, Xuc, Xuc, Xuc, Xuc, Xuc, Xuc, Xuc, Xuc, Xuc, Xuc, Xuc, Xuc, Xuc, Xuc, Xuc, Xuc, Xuc, Xuc, Xuc, Xuc, Xuc, Xuc, Xuc, Xuc, Xuc, Xuc, Xuc, Xue, Xue, Xue, Xue, Xue, Xue
Uue, Uue, Uue^Vct, Ce, Ce, Uue, Uue^Vct, Uue, Uue, Uue, Uue, Xuc, Xue, Xuc, Xuc, Xuc, Xuc, Xuc, Xuc, Xuc, Xuc, Xuc, Xuc, Xuc, Xuc, Xuc, Xuc, Xuc, Xuc, Xuc, Xuc, Xuc, Xuc, Xuc, Xuc, Xuc, Xuc, Xuc, Xuc, Xuc, Xuc, Xuc, Xuc, Xuc, Xuc, Xuc, Xuc, Xuc, Xuc, Xuc, Xue, Xue, Xue, Xue, Xue, Xue
Uue, Uue, Uue, Ce, 1 Ke, Ce, Ce, Ce, Uue^Vct, Uue, Uue, Uue, Xue, Xue, Xuc, Xuc, Xuc, Xuc, Xuc, Xuc, Xuc, Xuc, Xuc, Xuc, Xuc, Xuc, Xuc, Xuc, Xuc, Xuc, Xuc, Xuc, Xuc, Xuc, Xuc, Xuc, Xuc, Xuc, Xuc, Xuc, Xuc, Xuc, Xuc, Xuc, Xuc, Xuc, Xuc, Xuc, Xuc, Xuc, Xue, Xue, Xue, Xue, Xue, Xue
Uue, Uue, Uue, Uue, Uue^Vct, Ce, Uue, Uue^Vct, Uue^Vct, Uue, Uue, Uue, Xue, Xue, Xuc, Xuc, Xuc, Xuc, Xuc, Xuc, Xuc, Xuc, Xuc, Xuc, Xuc, Xuc, Xuc, Xuc, Xuc, Xuc, Xuc, Xuc, Xuc, Xuc, Xuc, Xuc, Xuc, Xuc, Xuc, Xuc, Xuc, Xuc, Xuc, Xuc, Xuc, Xuc, Xuc, Xuc, Xuc, Xuc, Xue, Xue, Xue, Xue, Xue, Xue
Uue, Uue, Uue, Uue, Uue, Uue, Uue, Uue, Uue, Uue, Xue, Xue, Xuc, Xuc, Xuc, Xuc, Xuc, Xuc, Xuc, Xuc, Xuc, Xuc, Xuc, Xuc, Xuc, Xuc, Xuc, Xuc, Xuc, Xuc, Xuc, Xuc, Xuc, Xuc, Xuc, Xuc, Xuc, Xuc, Xuc, Xuc, Xuc, Xuc, Xuc, Xuc, Xuc, Xuc, Xuc, Xuc, Xuc, Xuc, Xue, Xue, Xue, Xue, Xue, Xue
Xue, Xue, Xue, Xue, Xue, Xue, Xue, Xue, Xue, Xue, Xuc, Xuc, Xuc, Xuc, Xuc, Xuc, Xuc, Xuc, Xuc, Xuc, Xuc, Xuc, Xuc, Xuc, Xuc, Xuc, Xuc, Xuc, Xuc, Xuc, Xuc, Xuc, Xuc, Xuc, Xuc, Xuc, Xuc, Xuc, Xuc, Xuc, Xuc, Xuc, Xuc, Xuc, Xuc, Xuc, Xuc, Xuc, Xuc, Xuc, Xue, Xue, Xue, Xue, Xue, Xue
