Xuc, Xuc, Xuc, Xuc, Xuc, Xuc, Xuc, Xuc, Xuc, Xuc, Xuc, Xuc, Xuc, Xuc, Xuc, Xuc, Xuc, Xuc, Xuc, Xuc, Xuc, Xuc, Xuc, Xuc, Xuc, Xuc, Xuc, Xuc, Xuc, Xuc, Xuc, Xuc, Xuc, Xuc, Xue, Wwg, Wog, Xue, Xue, Xue, Xuc, Xuc, Xuc, Xue, Uue, Xue, Xuc, Xuc, Xuc, Xuc, Xue, Xue, Xue, Xue, Xue, Xue
Xuc, Xuc, Xuc, Xuc, Xuc, Xuc, Xuc, Xuc, Xuc, Xuc, Xuc, Xuc, Xuc, Xuc, Xuc, Xuc, Xuc, Xuc, Xuc, Xuc, Xuc, Xuc, Xuc, Xuc, Xuc, Xuc, Xuc, Xuc, Xuc, Xuc, Xuc, Xuc, Xue, Xue, Xue, Wog, Wog, Xue, Wwg, Xue, Xue, Xuc, Xuc, Xue, Re, Xue, Xue, Xuc, Xuc, Xuc, Xue, Xue, Xue, Xue, Xue, Xue
Xuc, Xuc, Xuc, Xuc, Xuc, Xuc, Xuc, Xuc, Xuc, Xuc, Xuc, Xuc, Xuc, Xuc, Xuc, Xuc, Xuc, Xuc, Xuc, Xuc, Xuc, Xuc, Xuc, Xuc, Xuc, Xuc, Xuc, Xuc, Xuc, Xuc, Xuc, Xuc, Xuc, Xue, Xue, Wwg, Wwg, Wwg, Wwg, Wwg, Tb^Tf, Xue, Xuc, Xue, Uue^Edb, Re^Edb, Xue, Xue, Xuc, Xuc, Xue, Xue, Xue, Xue, Xue, Xue
Xuc, Xuc, Xuc, Xuc, Xuc, Xuc, Xuc, Xuc, Xuc, Xuc, Xuc, Xuc, Xuc, Xuc, Xuc, Xuc, Xuc, Xuc, Xuc, Xuc, Xuc, Xuc, Xuc, Xuc, Xuc, Xuc, Xuc, Xuc, Xue, Xue, Xue, Xue, Xue, Xue, Xue, Xue, Xue, Tb^Tf, Wwg, Wwg, Wwg, Tb^Tf, Xue, Xue, Xue, Re^Edb, Re^Edb, Xue, Xuc, Xuc, Xue, Xue, Xue, Xue, Xue, Xue
Xuc, Xuc, Xuc, Xuc, Xuc, Xuc, Xuc, Xuc, Xuc, Xuc, Xuc, Xuc, Xuc, Xuc, Xuc, Xuc, Xuc, Xuc, Xuc, Xuc, Xuc, Xuc, Xuc, Xuc, Xuc, Xuc, Xuc, Xuc, Xue, Xue, Uhe, Xue, Uhe, Xue, Xue, Xuc, Xuc, Xue, Tb^Tf, Tb^Emf, Tb^Emf, Tb^Emf, Uue^Emf, Xue, Uue, Uue^Vu, Re^Edb, Xue, Xue, Xuc, Xue, Xue, Uue, Uue, Uue, Uue
Xuc, Xuc, Xuc, Xuc, Xuc, Xuc, Xuc, Xuc, Xuc, Xuc, Xuc, Xuc, Xuc, Xuc, Xuc, Xuc, Xuc, Xuc, Xuc, Xuc, Xuc, Xuc, Xuc, Xuc, Xuc, Xuc, Xuc, Xue, Xue, Uhe, Uhe, Uhe, Uhe, Uhe, Xuc, Xuc, Xuc, Xuc, Xue, Tb^Emf, Re, Tb^Emf, Re^Ecf, Uue^Es, Cte, Cte, Cte, Uue, Uhe, Xue, Xue, Xue, Re^Edb, Re, Xue, Uue
Xuc, Xuc, Xuc, Xuc, Xuc, Xuc, Xuc, Xuc, Xuc, Xuc, Xuc, Xuc, Xuc, Xuc, Xuc, Xuc, Xuc, Xuc, Xuc, Xuc, Xuc, Xuc, Xuc, Xuc, Xuc, Xuc, Xuc, Xuc, Xue, Uhe, Uhe, Uue^Dr, Uue, Xuc, Xuc, Xuc, Xuc, Xue, Uhe, Uue^Vu, Uhe, Re, Uue, Re, Cte, 2 Ke, Cte, Uue^Es, Uue^Es, Xue, Uue^Edb, Re^Edb, Uue^Edb, Xue, Xue, Xue
Xuc, Xuc, Xuc, Xuc, Xuc, Xuc, Xuc, Xuc, Xuc, Xuc, Xuc, Xuc, Xuc, Xuc, Xuc, Xuc, Xuc, Xuc, Xue, Xuc, Xuc, Xuc, Xuc, Xuc, Xuc, Xuc, Xuc, Xuc, Xuc, Xue, Xue, Xue, Xuc, Uue, Re^Es, Uhe^Vu, Xuc, Xue, Xue, Xue, Uhe, Uhe^Es, Uue, Kte, Kte, Cte, Re, Re, Re^Edb, Uhe, Re, Re^Edb, Xue, Xue, Xue, Xue
Xuc, Xuc, Xuc, Xuc, Xuc, Xuc, Xuc, Xuc, Xuc, Xuc, Xuc, Xuc, Xuc, Xuc, Xuc, Xuc, Xuc, Xue, Xue, Xue, Xue, Xuc, Xuc, Xuc, Xuc, Xuc, Xuc, Xuc, Xuc, Xuc, Xuc, Xuc, Tb^Tf, Re^Es, Uue^Es, Re^Es, Re, Xuc, Xuc, Xue, Xuc, Uue, Re^Dr, Re, Uue, Kte, Uue, Re, Uue^Vu, Uue, Xue, Xue, Xue, Xue, Xue, Xue
Xuc, Xuc, Xuc, Xuc, Xuc, Xuc, Xuc, Xuc, Xuc, Xuc, Xuc, Xuc, Xuc, Xuc, Xuc, Xuc, Xue, Xue, Uhe, Uhe^Dr, Uhe, Xue, Xuc, Xuc, Xuc, Xuc, Xuc, Xuc, Xuc, Xuc, Xuc, Xuc, Xuc, Uhe^Vu, Xuc, Re^Es, Cte^Bp/, Xuc, Qxu, Xuc^Efs, Uue^Es, Re^Es, Re^Es, Re, Uue, Uhe^Es, Uhe, Uue^Es, Uhe, Uhe, Qxe, Qxe, Qxe, Xue, Xue, Xue
Xuc, Xuc, Xuc, Xuc, Xuc, Xuc, Xuc, Xuc, Xuc, Xuc, Xuc, Xuc, Xuc, Xuc, Xuc, Xuc, Xue, Xue, Uhe, Uhe, Xue, Xue, Xuc, Xuc, Xuc, Xuc, Xuc, Xuc, Xuc, Xuc, Xuc, Xuc, Xuc, Xuc, Qxu^Bp/, Qxu^Bp/, Qxu^Bp|, Qxu^Bp\, Re^Edb, Re^Es, Re^Es, Re^Es, Xuc, Xuc, Xue, Uhe, Xue, Uhe^Es, Xue, Qxe, Qxe, Qxe, Xue, Qxe, Xue, Xue
Xuc, Xuc, Xuc, Xuc, Xuc, Xuc, Xuc, Xuc, Xuc, Xuc, Xuc, Xuc, Xuc, Xuc, Xuc, Xuc, Xue, Uhe^Dr, Uhe, Uhe, Uue, Uue^Dr, Uue, Xuc, Xuc, Xuc, Xuc, Xuc, Xuc, Xuc, Xuc, Xuc, Qxu^Bp/, Qxu^Bp/, Qxu, Qxu, Cer^Ecf, Uue^Edb, Re^Es, Re^Es, Qxu^Bp\, Qxu^Bp|, Xuc, Xuc, Xuc, Xue, Xue, Xue, Xuc, Qxe, Xue, Qxe, Xue, Xue, Xue, Xue
Xuc, Xuc, Xuc, Xuc, Xuc, Xuc, Xuc, Xuc, Xuc, Xuc, Xuc, Xuc, Xuc, Xuc, Xuc, Xuc, Xuc, Xue, Xue, Xue, Uue^Emf, Kte, Cte, Uue, Uue, Tb^Tf, Xuc, Xuc, Xuc, Xuc, Qxu^Bp/, Qxu^Bp/, Qxu, Qxu, Uue^Es, Re^Es, Re^Es, Cte^Vu, Qxu, Qxu, Qxu^Bp/, Cte^Bp/, Re^Es, Xuc, Xuc, Xuc, Xuc, Xuc, Xuc, Xuc, Xue, Xue, Xue, Xue, Xue, Xue
Xuc, Xuc, Xuc, Xuc, Xuc, Xuc, Xuc, Xuc, Xue, Xue, Xue, Xue, Xue, Xue, Xuc, Xuc, Xuc, Xuc, Xuc, Xue, Xue, Cte, Uhe^Vu, Re, Re, Uhe^Vu, Rb, Xuc, Qxu^Bp/, Qxu^Bp/, Qxu, Qxu, Re^Vu, Uhe^Es, Uue^Dr, Re^Es, Qxu, Qxu, Qxu^Bp/, Qxu^Bp/, Xuc, Re, Re^Es, Uhe^Vu, Uue, Xuc, Xuc, Xuc, Xuc, Xuc, Xue, Xue, Xue, Xue, Xue, Xue
Xuc, Xuc, Xuc, Xuc, Xuc, Xuc, Xuc, Xuc, Xue, Xue, Uhe, Xue, Uhe^Dr, Xue, Xuc, Xuc, Xuc, Xuc, Xuc, Xuc, Sm, Cte, Cte, Re, Xuc, Re, Cte^Bp/, Xuc^Efs, Qxu, Qxu, Re^Es, Re^Edb, Re^Es, Re^Es, Qxu, Qxu, Qxu^Bp/, Qxu^Bp/, Xuc, Xuc, Tb, Uue^Es, Uhe^Vu, Re^Es, Re, Xuc, Uhe, Xuc, Xuc, Xuc, Xue, Xue, Xue, Xue, Xue, Xue
Xuc, Xuc, Xuc, Xuc, Xuc, Xuc, Xuc, Xue, Xue, Uhe^Dr, Uhe, Uhe, Xue, Xue, Xuc, Xuc, Xuc, Xuc, Xuc, Xuc, Xuc, Xuc, Xuc, Xuc, Qxu^Bp/, Qxu^Bp/, Qxu^Bp|, Qxu^Bp\, Uhe, Uue, Re^Es, Re^Es, Qxu, Qxu, Qxu^Bp/, Qxu^Bp/, Xuc, Xuc, Xuc, Xuc, Tb, Uue, Xuc, Xuc, Uhe, Uue, Uue^Dr, Uhe, Xuc, Xuc, Xue, Xue, Xue, Xue, Xue, Xue
Xuc, Xuc, Xuc, Xuc, Xuc, Xuc, Xuc, Xue, Xue, Uhe, Xue, Uue^Dr, Uue, Xuc, Xuc, Xuc, Xuc, Xuc, Xuc, Xuc, Xuc, Xuc, Qxu^Bp/, Qxu^Bp/, Qxu, Qxu, Cte^Vu, Uue, Rb, Re^Dr, Qxu^Bp\, Qxu^Bp|, Xuc, Qxu^Bp/, Xuc, Xuc, Xuc, Xuc, Xuc, Xuc, Xuc, Xuc, Xuc, Xuc, Xuc, Uhe, Uhe, Uhe, Xuc, Xuc, Xue, Xue, Xue, Xue, Xue, Xue
Xuc, Xuc, Xuc, Xuc, Xuc, Xuc, Xuc, Xuc, Xue, Xue, Xuc, Xue, Xuc, Tb^Tf, Uue, Uhe^Vu, Xuc, Xuc, Xuc, Xuc, Qxu^Bp/, Qxu^Bp/, Qxu, Qxu, Re^Es, Uue^Dr, Re^Es, Cer^Ecf, Qxu, Qxu, Qxu^Bp/, Cte^Bp/, Uue, Xuc, Xuc, Xuc, Xuc, Xuc, Xuc, Xuc, Xuc, Xuc, Xuc, Xuc, Xuc, Xuc, Xuc, Xuc, Xuc, Xuc, Xue, Xue, Xue, Xue, Xue, Xue
Xuc, Xuc, Xuc, Xuc, Xuc, Xuc, Xuc, Xuc, Xuc, Xuc, Xuc, Xuc, Uue, Re, Re, Uue, Rb, Xuc, Qxu^Bp/, Qxu^Bp/, Qxu, Qxu, Re^Es, Re^Dr, Uue^Edb, Re^Es, Qxu, Qxu, Qxu^Bp/, Qxu^Bp/, Xuc, Rb, Re, Tb, Uhe^Vu, Xuc, Xuc, Xuc, Xuc, Xuc, Xuc, Xuc, Xuc, Xuc, Xuc, Xuc, Xuc, Xuc, Xuc, Xuc, Xue, Xue, Xue, Xue, Xue, Xue
Xuc, Xuc, Xuc, Xuc, Xuc, Xuc, Xuc, Xuc, Xuc, Xuc, Xuc, Tb^Tf, Uue, Uhe^Vu, Xuc, Re, Cte^Bp/, Xuc^Efs, Qxu, Qxu, Re^Es, Uue, Re^Es, Uue^Vu, Qxu, Qxu, Qxu^Bp/, Qxu^Bp/, Xuc, Xuc, Tb^Tf, Uue, Re, Re, Cte, Xuc, Xuc, Xuc, Xuc, Xuc, Xuc, Xuc, Xuc, Xuc, Xuc, Xuc, Xuc, Xuc, Xuc, Xuc, Xue, Xue, Xue, Xue, Xue, Xue
Xuc, Xuc, Xuc, Xuc, Xuc, Xuc, Xuc, Xuc, Xuc, Xuc, Xuc, Xuc, Xuc, Xuc, Qxu^Bp/, Qxu^Bp/, Qxu^Bp|, Qxu^Bp\, Re^Es, Uue^Dr, Uue^Es, Uue^Dr, Qxu, Qxu, Qxu^Bp/, Qxu^Bp/, Xuc, Xuc, Xuc, Xuc, Uue, Uhe^Vu, Cte, Kte, Cte, Uue^Emf, Uue^Dr, Xuc, Xuc, Xuc, Xuc, Xuc, Xuc, Xuc, Xuc, Xuc, Xuc, Xuc, Xuc, Xuc, Xue, Xue, Xue, Xue, Xue, Xue
Xuc, Xuc, Xuc, Xuc, Xuc, Xuc, Xuc, Xuc, Xuc, Xuc, Xuc, Xuc, Qxu^Bp/, Qxu^Bp/, Qxu, Qxu, Cer^Ecf, Uue^Edb, Re^Es, Re^Es, Qxu^Bp\, Qxu^Bp|, Xuc, Qxu^Bp/, Xuc, Xuc, Xuc, Xuc, Xuc, Xuc, Xuc, Cte, Sm, Sm, Uue, Cte, Uhe, Xuc, Xuc, Xuc, Xuc, Xuc, Xuc, Xuc, Xuc, Xuc, Xuc, Xuc, Xuc, Xuc, Xue, Xue, Xue, Xue, Xue, Xue
Xuc, Xuc, Xuc, Xuc, Xuc, Xuc, Xuc, Xuc, Xuc, Xuc, Qxu^Bp/, Qxu^Bp/, Qxu, Qxu, Re^Dr, Uue, Re^Es, Cte^Vu, Qxu, Qxu, Qxu^Bp/, Cte^Bp/, Re, Xuc, Xuc, Xuc, Xuc, Xuc, Xuc, Xuc, Xuc, Xue, Xuc, Uhe, Uhe, Uhe, Uhe, Xue, Xue, Xuc, Xuc, Xuc, Xuc, Xuc, Xuc, Xuc, Xuc, Xuc, Xuc, Xuc, Xue, Xue, Xue, Xue, Xue, Xue
Xuc, Xuc, Xuc, Xuc, Xuc, Xuc, Xuc, Xuc, Qxu^Bp/, Qxu^Bp/, Qxu, Qxu, Uue^Vu, Re^Es, Re^Es, Re^Es, Qxu, Qxu, Qxu^Bp/, Qxu^Bp/, Xuc, Rb, Re^Es, Uhe^Vu, Tb, Xuc, Xuc, Xuc, Xue, Xuc, Xuc, Xuc, Xuc, Uhe, Xue, Xue, Xue, Uhe, Xue, Xuc, Xuc, Xuc, Xuc, Xuc, Xuc, Xuc, Xuc, Xuc, Xuc, Xuc, Xue, Xue, Xue, Xue, Xue, Xue
Xuc, Xuc, Xue, Xuc, Xue, Xuc, Qxu^Bp/, Qxu^Bp/, Qxu, Qxu, Uue^Edb, Re^Es, Uue^Dr, Uhe^Es, Qxu, Qxu, Qxu^Bp/, Qxu^Bp/, Xuc, Xuc, Tb^Tf, Uue^Es, Uue^Es, Re, Re, Xuc, Xue, Xue, Xue, Xuc, Xuc, Xuc, Xuc, Xuc, Xuc, Xuc, Xuc, Xue, Xuc, Xuc, Xuc, Xuc, Xuc, Xuc, Xuc, Xuc, Xuc, Xuc, Xuc, Xuc, Xue, Xue, Xue, Xue, Xue, Xue
Xue, Xue, Xue, Xue, Xue, Xuc, Xuc^Efs, Qxu, Uue^Es, Uue^Edb, Re^Es, Re^Es, Qxu, Qxu, Qxu^Bp/, Qxu^Bp/, Xuc, Xuc, Xuc, Xuc, Uue, Uhe^Vu, Xuc, Xuc, Uhe, Uue, Uue^Dr, Uhe, Xue, Xuc, Xuc, Xuc, Xuc, Xuc, Xuc, Xuc, Xuc, Xuc, Xuc, Xuc, Xuc, Xuc, Xuc, Xuc, Xuc, Xuc, Xuc, Xuc, Xuc, Xuc, Xue, Xue, Xue, Xue, Xue, Xue
Mm, Xue, Xue, Uhe^Es, Uhe^Es, Uhe, Uue^Edt, Cte^Es, Cte^Es, Re^Es, Qxu, Qxu, Qxu^Bp/, Qxu^Bp/, Xuc, Xuc, Xuc, Xuc, Xuc, Xuc, Xuc, Xuc, Xuc, Xuc, Xue, Uhe, Uhe, Uhe, Xue, Xuc, Xuc, Xuc, Xuc, Xuc, Xuc, Xuc, Xuc, Xuc, Xuc, Xuc, Xuc, Xuc, Xuc, Xuc, Xuc, Xuc, Xuc, Xuc, Xuc, Xuc, Xue, Xue, Xue, Xue, Xue, Xue
Mm, Tb, Tb, Tb, Ce, Uue^Edt, Uue^Edt, Rb, Uue, Xuc, Xuc, Qxu^Bp/, Xuc, Xuc, Xuc, Xuc, Xuc, Xuc, Xuc, Xuc, Xuc, Xuc, Xuc, Xue, Xue, Uue, Xue, Xue, Xuc, Xuc, Xuc, Xuc, Xuc, Xuc, Xuc, Xuc, Xuc, Xuc, Xuc, Xuc, Xuc, Xuc, Xuc, Xuc, Xuc, Xuc, Xuc, Xuc, Xuc, Xuc, Xue, Xue, Xue, Xue, Xue, Xue
Mm, Mm, Uue^Vct, Ce, Ce, Uue^Edt, Uue^Vct, Re^Dr, Re^Edt, Uue^Edt, Uhe, Xuc, Xue, Xuc, Xuc, Xuc, Xuc, Xuc, Xuc, Xuc, Xuc, Xuc, Xuc, Xuc, Xuc, Xuc, Xuc, Xuc, Xuc, Xuc, Xuc, Xuc, Xuc, Xuc, Xuc, Xuc, Xuc, Xuc, Xuc, Xuc, Xuc, Xuc, Xuc, Xuc, Xuc, Xuc, Xuc, Xuc, Xuc, Xuc, Xue, Xue, Xue, Xue, Xue, Xue
Gs, Re^Es, Uue^Edt, Ce, 1 Ke, Ce, Ce, Ce, Re^Vct, Uue^Edt, Xue, Xue, Xue, Xue, Xuc, Xuc, Xuc, Xuc, Xuc, Xuc, Xuc, Xuc, Xuc, Xuc, Xuc, Xuc, Xuc, Xuc, Xuc, Xuc, Xuc, Xuc, Xuc, Xuc, Xuc, Xuc, Xuc, Xuc, Xuc, Xuc, Xuc, Xuc, Xuc, Xuc, Xuc, Xuc, Xuc, Xuc, Xuc, Xuc, Xue, Xue, Xue, Xue, Xue, Xue
Re, Re, Re, Re^Edt, Re^Vct, Ce, Re^Edt, Re^Vct, Uue^Vct, Uhe^Es, Xue, Xue, Xue, Xue, Xuc, Xuc, Xuc, Xuc, Xuc, Xuc, Xuc, Xuc, Xuc, Xuc, Xuc, Xuc, Xuc, Xuc, Xuc, Xuc, Xuc, Xuc, Xuc, Xuc, Xuc, Xuc, Xuc, Xuc, Xuc, Xuc, Xuc, Xuc, Xuc, Xuc, Xuc, Xuc, Xuc, Xuc, Xuc, Xuc, Xue, Xue, Xue, Xue, Xue, Xue
Gs, Gs, Mm, Uue, Uhe, Uue, Tb, Uue, Uhe, Uue^Es, Xue, Xue, Xuc, Xuc, Xuc, Xuc, Xuc, Xuc, Xuc, Xuc, Xuc, Xuc, Xuc, Xuc, Xuc, Xuc, Xuc, Xuc, Xuc, Xuc, Xuc, Xuc, Xuc, Xuc, Xuc, Xuc, Xuc, Xuc, Xuc, Xuc, Xuc, Xuc, Xuc, Xuc, Xuc, Xuc, Xuc, Xuc, Xuc, Xuc, Xue, Xue, Xue, Xue, Xue, Xue
Mm, Mm, Mm, Mm, Mm, Mm, Mm, Xue, Xue, Xue, Xuc, Xuc, Xuc, Xuc, Xuc, Xuc, Xuc, Xuc, Xuc, Xuc, Xuc, Xuc, Xuc, Xuc, Xuc, Xuc, Xuc, Xuc, Xuc, Xuc, Xuc, Xuc, Xuc, Xuc, Xuc, Xuc, Xuc, Xuc, Xuc, Xuc, Xuc, Xuc, Xuc, Xuc, Xuc, Xuc, Xuc, Xuc, Xuc, Xuc, Xue, Xue, Xue, Xue, Xue, Xue

