Xuc, Xuc, Xuc, Xuc, Xuc, Xuc, Xuc, Xuc, Xuc, Xuc, Xuc, Xuc, Xuc, Xuc, Xuc, Xuc, Xuc, Xuc, Xuc, Xuc, Xuc, Xuc, Xuc, Xuc, Xuc, Xuc, Xuc, Xuc, Xuc, Xuc, Xuc, Xuc, Xuc, Xuc, Xue, Wwg, Wog, Xue, Xue, Xue, Xuc, Xuc, Xuc, Xue, Uue, Xue, Xuc, Xuc, Xuc, Xuc, Xue, Xue, Xue, Xue, Xue, Xue
Xuc, Xuc, Xuc, Xuc, Xuc, Xuc, Xuc, Xuc, Xuc, Xuc, Xuc, Xuc, Xuc, Xuc, Xuc, Xuc, Xuc, Xuc, Xuc, Xuc, Xuc, Xuc, Xuc, Xuc, Xuc, Xuc, Xuc, Xuc, Xuc, Xuc, Xuc, Xuc, Xue, Xue, Xue, Wog, Wog, Xue, Wwg, Xue, Xue, Xuc, Xuc, Xue, Re, Xue, Xue, Xuc, Xuc, Xuc, Xue, Xue, Xue, Xue, Xue, Xue
Xuc, Xuc, Xuc, Xuc, Xuc, Xuc, Xuc, Xuc, Xuc, Xuc, Xuc, Xuc, Xuc, Xuc, Xuc, Xuc, Xuc, Xuc, Xuc, Xuc, Xuc, Xuc, Xuc, Xuc, Xuc, Xuc, Xuc, Xuc, Xuc, Xuc, Xuc, Xuc, Xuc, Xue, Xue, Wwg, Wwg, Wwg, Wwg, Wwg, Tb^Tf, Xue, Xuc, Xue, Uue, Re, Xue, Xue, Xuc, Xuc, Xue, Xue, Xue, Xue, Xue, Xue
Xuc, Xuc, Xuc, Xuc, Xuc, Xuc, Xuc, Xuc, Xuc, Xuc, Xuc, Xuc, Xuc, Xuc, Xuc, Xuc, Xuc, Xuc, Xuc, Xuc, Xuc, Xuc, Xuc, Xuc, Xuc, Xuc, Xuc, Xuc, Xuc, Xuc, Xuc, Xuc, Xuc, Xuc, Xuc, Xue, Xue, Tb^Tf, Wwg, Wwg, Wwg, Tb^Tf, Xue, Xue, Xue, Re, Re, Xue, Xuc, Xuc, Xue, Xue, Xue, Xue, Xue, Xue
Xuc, Xuc, Xuc, Xuc, Xuc, Xuc, Xuc, Xuc, Xuc, Xuc, Xuc, Xuc, Xuc, Xuc, Xuc, Xuc, Xuc, Xuc, Xuc, Xuc, Xuc, Xuc, Xuc, Xuc, Xuc, Xuc, Xuc, Xuc, Xuc, Xuc, Xuc, Xuc, Xuc, Xuc, Xuc, Xuc, Xuc, Xue, Tb^Tf, Tb^Emf, Tb^Emf, Tb^Emf, Uue, Xue, Uue, Uue^Vu, Re, Xue, Xue, Xuc, Xue, Xue, Uue, Uue, Uue, Uue
Xuc, Xuc, Xuc, Xuc, Xuc, Xuc, Xuc, Xuc, Xuc, Xuc, Xuc, Xuc, Xuc, Xuc, Xuc, Xuc, Xuc, Xuc, Xuc, Xuc, Xuc, Xuc, Xuc, Xuc, Xuc, Xuc, Xuc, Xuc, Xuc, Xuc, Xuc, Xuc, Xuc, Xuc, Xuc, Xuc, Xuc, Xuc, Xue, Tb, Re, Tb, Re^Ecf, Uue, Cte, Cte, Cte, Uue, Uhe, Xue, Xue, Xue, Re, Re, Xue, Uue
Xuc, Xuc, Xuc, Xuc, Xuc, Xuc, Xuc, Xuc, Xuc, Xuc, Xuc, Xuc, Xuc, Xuc, Xuc, Xuc, Xuc, Xuc, Xuc, Xuc, Xuc, Xuc, Xuc, Xuc, Xuc, Xuc, Xuc, Xuc, Xuc, Xuc, Xuc, Uue^Dr, Uue, Xuc, Xuc, Xuc, Xuc, Xue, Uhe, Uue^Vu, Uhe, Re, Uue, Re, Cte, 2 Ke, Cte, Uue, Uue, Xue, Uue, Re, Uue, Xue, Xue, Xue
Xuc, Xuc, Xuc, Xuc, Xuc, Xuc, Xuc, Xuc, Xuc, Xuc, Xuc, Xuc, Xuc, Xuc, Xuc, Xuc, Xuc, Xuc, Xuc, Xuc, Xuc, Xuc, Xuc, Xuc, Xuc, Xuc, Xuc, Xuc, Xuc, Xuc, Xuc, Xuc, Xuc, Uue, Re^Es, Uhe^Vu, Xuc, Xue, Xue, Xue, Uhe, Uhe, Uue, Uue, Uue, Cte, Re, Re, Re, Uue, Re, Re, Xue, Xue, Xue, Xue
Xuc, Xuc, Xuc, Xuc, Xuc, Xuc, Xuc, Xuc, Xuc, Xuc, Xuc, Xuc, Xuc, Xuc, Xuc, Xuc, Xuc, Xuc, Xuc, Xuc, Xuc, Xuc, Xuc, Xuc, Xuc, Xuc, Xuc, Xuc, Xuc, Xuc, Xuc, Xuc, Tb^Tf, Re^Es, Uue^Es, Re^Es, Xuc, Xuc, Xuc, Xue, Xuc, Uue, Re, Uue^Vu, Uue, Uue, Uue, Re, Uue^Vu, Uue, Xue, Xue, Xue, Xue, Xue, Xue
Xuc, Xuc, Xuc, Xuc, Xuc, Xuc, Xuc, Xuc, Xuc, Xuc, Xuc, Xuc, Xuc, Xuc, Xuc, Xuc, Xuc, Xuc, Xuc, Xuc, Xuc, Xuc, Xuc, Xuc, Xuc, Xuc, Xuc, Xuc, Xuc, Xuc, Xuc, Xuc, Xuc, Uhe^Vu, Xuc, Re^Es, Cte, Xuc, Qxe, Xuc^Efs, Uue^Es, Re, Uue, Uue, Uue, Uhe, Uhe, Uue, Uue, Uue, Xue, Xue, Xue, Xue, Xue, Xue
Xuc, Xuc, Xuc, Xuc, Xuc, Xuc, Xuc, Xuc, Xuc, Xuc, Xuc, Xuc, Xuc, Xuc, Xuc, Xuc, Xuc, Xuc, Xuc, Xuc, Xuc, Xuc, Xuc, Xuc, Xuc, Xuc, Xuc, Xuc, Xuc, Xuc, Xuc, Xuc, Xuc, Xuc, Qxu^Bp/, Qxu^Bp/, Qxe, Qxu^Bp\, Re^Edb, Re^Es, Uue^Es, Re^Es, Xuc, Xuc, Xue, Uhe, Xue, Uhe, Xue, Xuc, Xue, Xue, Xue, Xue, Xue, Xue
Xuc, Xuc, Xuc, Xuc, Xuc, Xuc, Xuc, Xuc, Xuc, Xuc, Xuc, Xuc, Xuc, Xuc, Xuc, Xuc, Xuc, Xuc, Xuc, Xuc, Uue, Uue^Dr, Uue, Xuc, Xuc, Xuc, Xuc, Xuc, Xuc, Xuc, Xuc, Xuc, Qxu^Bp/, Qxu^Bp/, Qxe, Qxe, Cer, Uue^Edb, Re^Edb, Re^Es, Qxu^Bp\, Qxe, Xuc, Xuc, Xuc, Xue, Xue, Xue, Xuc, Xuc, Xue, Xue, Xue, Xue, Xue, Xue
Xuc, Xuc, Xuc, Xuc, Xuc, Xuc, Xuc, Xuc, Xuc, Xuc, Xuc, Xuc, Xuc, Xuc, Xuc, Xuc, Xuc, Xuc, Xuc, Xue, Uue^Emf, Kte, Cte, Uue, Uue, Tb^Tf, Xuc, Xuc, Xuc, Xuc, Qxu^Bp/, Qxu^Bp/, Qxe, Qxe, Uue^Es, Re^Es, Re^Es, Cer^Edb, Qxe, Qxe, Qxu^Bp/, Cte, Re^Es, Xuc, Xuc, Xuc, Xuc, Xuc, Xuc, Xuc, Xue, Xue, Xue, Xue, Xue, Xue
Xuc, Xuc, Xuc, Xuc, Xuc, Xuc, Xuc, Xuc, Xuc, Xuc, Xuc, Xuc, Xuc, Xuc, Xuc, Xuc, Xuc, Xuc, Xuc, Xue, Xue, Cte, Uhe^Vu, Re, Re, Uhe^Vu, Xuc, Xuc, Qxu^Bp/, Qxu^Bp/, Qxe, Qxe, Re^Es, Uhe^Es, Uue^Dr, Re^Es, Qxe, Qxe, Qxu^Bp/, Qxu^Bp/, Xuc, Xuc, Re^Es, Uhe^Vu, Uue, Xuc, Xuc, Xuc, Xuc, Xuc, Xue, Xue, Xue, Xue, Xue, Xue
Xuc, Xuc, Xuc, Xuc, Xuc, Xuc, Xuc, Xuc, Xuc, Xuc, Xuc, Xuc, Xuc, Xuc, Xuc, Xuc, Xuc, Xuc, Xuc, Xuc, Sm, Cte, Cte, Re, Xuc, Re, Cte, Xuc^Efs, Qxe, Qxe, Re^Es, Re^Edb, Uue^Es, Re, Qxe, Qxe, Qxu^Bp/, Qxu^Bp/, Xuc, Xuc, Tb, Uue^Es, Uhe^Vu, Re^Es, Re, Xuc, Xuc, Xuc, Xuc, Xuc, Xue, Xue, Xue, Xue, Xue, Xue
Xuc, Xuc, Xuc, Xuc, Xuc, Xuc, Xuc, Xuc, Xuc, Xuc, Xuc, Xuc, Xuc, Xuc, Xuc, Xuc, Xuc, Xuc, Xuc, Xuc, Xuc, Xuc, Xuc, Xuc, Qxu^Bp/, Qxu^Bp/, Qxe, Qxu^Bp\, Uhe, Uue, Re^Es, Uue^Es, Qxe, Qxe, Qxu^Bp/, Qxu^Bp/, Xuc, Xuc, Xuc, Xuc, Tb, Uue, Xuc, Xuc, Xuc, Uue, Uue^Dr, Xuc, Xuc, Xuc, Xue, Xue, Xue, Xue, Xue, Xue
Xuc, Xuc, Xuc, Xuc, Xuc, Xuc, Xuc, Xuc, Xuc, Xuc, Xuc, Uue^Dr, Uue, Xuc, Xuc, Xuc, Xuc, Xuc, Xuc, Xuc, Xuc, Xuc, Qxu^Bp/, Qxu^Bp/, Qxe, Qxe, Cer, Uue, Re, Re^Es, Qxu^Bp\, Qxe, Xuc, Qxu^Bp/, Xuc, Xuc, Xuc, Xuc, Xuc, Xuc, Xuc, Xuc, Xuc, Xuc, Xuc, Xuc, Xuc, Xuc, Xuc, Xuc, Xue, Xue, Xue, Xue, Xue, Xue
Xuc, Xuc, Xuc, Xuc, Xuc, Xuc, Xuc, Xuc, Xuc, Xuc, Xuc, Xuc, Xuc, Tb^Tf, Uue, Uhe^Vu, Xuc, Xuc, Xuc, Xuc, Qxu^Bp/, Qxu^Bp/, Qxe, Qxe, Re^Es, Uue^Dr, Uue, Cer, Qxe, Qxe, Qxu^Bp/, Cte, Uue, Xuc, Xuc, Xuc, Xuc, Xuc, Xuc, Xuc, Xuc, Xuc, Xuc, Xuc, Xuc, Xuc, Xuc, Xuc, Xuc, Xuc, Xue, Xue, Xue, Xue, Xue, Xue
Xuc, Xuc, Xuc, Xuc, Xuc, Xuc, Xuc, Xuc, Xuc, Xuc, Xuc, Xuc, Uue, Re, Re, Uue, Xuc, Xuc, Qxu^Bp/, Qxu^Bp/, Qxe, Qxe, Re^Es, Re^Es, Uue^Edb, Re^Edb, Qxe, Qxe, Qxu^Bp/, Qxu^Bp/, Xuc, Xuc, Re, Tb, Uhe^Vu, Xuc, Xuc, Xuc, Xuc, Xuc, Xuc, Xuc, Xuc, Xuc, Xuc, Xuc, Xuc, Xuc, Xuc, Xuc, Xue, Xue, Xue, Xue, Xue, Xue
Xuc, Xuc, Xuc, Xuc, Xuc, Xuc, Xuc, Xuc, Xuc, Xuc, Xuc, Tb^Tf, Uue, Uhe^Vu, Xuc, Re, Cte, Xuc^Efs, Qxe, Qxe, Uue^Es, Uue, Re^Es, Uue^Es, Qxe, Qxe, Qxu^Bp/, Qxu^Bp/, Xuc, Xuc, Tb^Tf, Uue, Re, Re, Uue^Es, Xuc, Xuc, Xuc, Xuc, Xuc, Xuc, Xuc, Xuc, Xuc, Xuc, Xuc, Xuc, Xuc, Xuc, Xuc, Xue, Xue, Xue, Xue, Xue, Xue
Xuc, Xuc, Xuc, Xuc, Xuc, Xuc, Xuc, Xuc, Xuc, Xuc, Xuc, Xuc, Xuc, Xuc, Qxu^Bp/, Qxu^Bp/, Qxe, Qxu^Bp\, Re, Uue^Es, Uue, Uue^Dr, Qxe, Qxe, Qxu^Bp/, Qxu^Bp/, Xuc, Xuc, Xuc, Xuc, Uue, Uhe^Vu, Cte, Kte, Cte, Uue^Emf, Uue^Dr, Xuc, Xuc, Xuc, Xuc, Xuc, Xuc, Xuc, Xuc, Xuc, Xuc, Xuc, Xuc, Xuc, Xue, Xue, Xue, Xue, Xue, Xue
Xuc, Xuc, Xuc, Xuc, Xuc, Xuc, Xuc, Xuc, Xuc, Xuc, Xuc, Xuc, Qxu^Bp/, Qxu^Bp/, Qxe, Qxe, Cer, Uue^Edb, Re^Es, Re^Es, Qxu^Bp\, Qxe, Xuc, Qxu^Bp/, Xuc, Xuc, Xuc, Xuc, Xuc, Xuc, Xuc, Uue, Sm, Sm, Uue, Cte, Xuc, Xuc, Xuc, Xuc, Xuc, Xuc, Xuc, Xuc, Xuc, Xuc, Xuc, Xuc, Xuc, Xuc, Xue, Xue, Xue, Xue, Xue, Xue
Xuc, Xuc, Xuc, Xuc, Xuc, Xuc, Xuc, Xuc, Xuc, Xuc, Qxu^Bp/, Qxu^Bp/, Qxe, Qxe, Re^Dr, Uue, Re^Es, Cer, Qxe, Qxe, Qxu^Bp/, Cte, Re, Xuc, Xuc, Xuc, Xuc, Xuc, Xuc, Xuc, Xuc, Xue, Xuc, Xue, Xue, Xue, Xuc, Xuc, Xuc, Xuc, Xuc, Xuc, Xuc, Xuc, Xuc, Xuc, Xuc, Xuc, Xuc, Xuc, Xue, Xue, Xue, Xue, Xue, Xue
Xuc, Xuc, Xuc, Xuc, Xuc, Xuc, Xuc, Xuc, Qxu^Bp/, Qxu^Bp/, Qxe, Qxe, Uue^Es, Re^Es, Uue^Edb, Re^Es, Qxe, Qxe, Qxu^Bp/, Qxu^Bp/, Xuc, Xuc, Re^Es, Uhe^Vu, Tb, Xuc, Xuc, Xuc, Xuc, Xuc, Xuc, Xuc, Xuc, Xuc, Xuc, Xuc, Xuc, Xuc, Xuc, Xuc, Xuc, Xuc, Xuc, Xuc, Xuc, Xuc, Xuc, Xuc, Xuc, Xuc, Xue, Xue, Xue, Xue, Xue, Xue
Xuc, Xuc, Xue, Xuc, Xue, Xuc, Qxu^Bp/, Qxu^Bp/, Qxe, Qxe, Uue^Edb, Re^Edb, Uue^Dr, Uhe^Es, Qxe, Qxe, Qxu^Bp/, Qxu^Bp/, Xuc, Xuc, Tb^Tf, Uue^Es, Uue^Es, Re, Re, Xuc, Xuc, Xuc, Xuc, Xuc, Xuc, Xuc, Xuc, Xuc, Xuc, Xuc, Xuc, Xuc, Xuc, Xuc, Xuc, Xuc, Xuc, Xuc, Xuc, Xuc, Xuc, Xuc, Xuc, Xuc, Xue, Xue, Xue, Xue, Xue, Xue
Xue, Xue, Xue, Xue, Xue, Xuc, Xuc^Efs, Qxe, Uue^Edb, Uue^Edb, Re^Es, Re^Edb, Qxe, Qxe, Qxu^Bp/, Qxu^Bp/, Xuc, Xuc, Xuc, Xuc, Uue, Uhe^Vu, Xuc, Xuc, Xuc, Uue, Uue^Dr, Xuc, Xuc, Xuc, Xuc, Xuc, Xuc, Xuc, Xuc, Xuc, Xuc, Xuc, Xuc, Xuc, Xuc, Xuc, Xuc, Xuc, Xuc, Xuc, Xuc, Xuc, Xuc, Xuc, Xue, Xue, Xue, Xue, Xue, Xue
Xue, Xue, Xue, Uhe^Es, Uhe^Es, Uhe, Uue^Edt, Cte^Es, Cte^Es, Re^Es, Qxe, Qxe, Qxu^Bp/, Qxu^Bp/, Xuc, Xuc, Xuc, Xuc, Xuc, Xuc, Xuc, Xuc, Xuc, Xuc, Xuc, Xuc, Xuc, Xuc, Xuc, Xuc, Xuc, Xuc, Xuc, Xuc, Xuc, Xuc, Xuc, Xuc, Xuc, Xuc, Xuc, Xuc, Xuc, Xuc, Xuc, Xuc, Xuc, Xuc, Xuc, Xuc, Xue, Xue, Xue, Xue, Xue, Xue
Xue, Tb, Tb, Tb, Ce, Uue^Edt, Uue^Edt, Re^Edt, Uue, Xuc, Xuc, Qxu^Bp/, Xuc, Xuc, Xuc, Xuc, Xuc, Xuc, Xuc, Xuc, Xuc, Xuc, Xuc, Xuc, Xuc, Xuc, Xuc, Xuc, Xuc, Xuc, Xuc, Xuc, Xuc, Xuc, Xuc, Xuc, Xuc, Xuc, Xuc, Xuc, Xuc, Xuc, Xuc, Xuc, Xuc, Xuc, Xuc, Xuc, Xuc, Xuc, Xue, Xue, Xue, Xue, Xue, Xue
Uue, Uue^Edt, Uue^Vct, Ce, Ce, Uue^Edt, Uue^Vct, Re, Re^Edt, Uue^Edt, Uhe, Xuc, Xue, Xuc, Xuc, Xuc, Xuc, Xuc, Xuc, Xuc, Xuc, Xuc, Xuc, Xuc, Xuc, Xuc, Xuc, Xuc, Xuc, Xuc, Xuc, Xuc, Xuc, Xuc, Xuc, Xuc, Xuc, Xuc, Xuc, Xuc, Xuc, Xuc, Xuc, Xuc, Xuc, Xuc, Xuc, Xuc, Xuc, Xuc, Xue, Xue, Xue, Xue, Xue, Xue
Uue, Re^Es, Uue^Edt, Ce, 1 Ke, Ce, Ce, Ce, Re^Vct, Uue^Edt, Uue^Edt, Uhe, Xue, Xue, Xuc, Xuc, Xuc, Xuc, Xuc, Xuc, Xuc, Xuc, Xuc, Xuc, Xuc, Xuc, Xuc, Xuc, Xuc, Xuc, Xuc, Xuc, Xuc, Xuc, Xuc, Xuc, Xuc, Xuc, Xuc, Xuc, Xuc, Xuc, Xuc, Xuc, Xuc, Xuc, Xuc, Xuc, Xuc, Xuc, Xue, Xue, Xue, Xue, Xue, Xue
Re, Re, Re^Edt, Re^Edt, Re^Vct, Ce, Re^Edt, Re^Vct, Uue^Vct, Uhe^Es, Uhe^Es, Uhe, Xue, Xue, Xuc, Xuc, Xuc, Xuc, Xuc, Xuc, Xuc, Xuc, Xuc, Xuc, Xuc, Xuc, Xuc, Xuc, Xuc, Xuc, Xuc, Xuc, Xuc, Xuc, Xuc, Xuc, Xuc, Xuc, Xuc, Xuc, Xuc, Xuc, Xuc, Xuc, Xuc, Xuc, Xuc, Xuc, Xuc, Xuc, Xue, Xue, Xue, Xue, Xue, Xue
Uue, Uue, Uue, Uue, Uhe, Uue, Tb, Uue, Uhe, Uue^Es, Xue, Xue, Xuc, Xuc, Xuc, Xuc, Xuc, Xuc, Xuc, Xuc, Xuc, Xuc, Xuc, Xuc, Xuc, Xuc, Xuc, Xuc, Xuc, Xuc, Xuc, Xuc, Xuc, Xuc, Xuc, Xuc, Xuc, Xuc, Xuc, Xuc, Xuc, Xuc, Xuc, Xuc, Xuc, Xuc, Xuc, Xuc, Xuc, Xuc, Xue, Xue, Xue, Xue, Xue, Xue
Xue, Xue, Xue, Xue, Xue, Xue, Xue, Xue, Xue, Xue, Xuc, Xuc, Xuc, Xuc, Xuc, Xuc, Xuc, Xuc, Xuc, Xuc, Xuc, Xuc, Xuc, Xuc, Xuc, Xuc, Xuc, Xuc, Xuc, Xuc, Xuc, Xuc, Xuc, Xuc, Xuc, Xuc, Xuc, Xuc, Xuc, Xuc, Xuc, Xuc, Xuc, Xuc, Xuc, Xuc, Xuc, Xuc, Xuc, Xuc, Xue, Xue, Xue, Xue, Xue, Xue
